██████████████████████▓░░░░░░░░░░ ░░░░░░▒▓▓▓▓▒▒▒▒▒▒▒▓▒▒▒▒▒▓▓▓▒▒▒▒▒▒▓▓▓▓▓▓▓▓▓▒▓▓▓▒▒▒▒▓▓▓▒▒▓▒▒▒▓▓▓▓▓▓▓▒▒▒▒▓▓▓▓▓▓▓▓▓▓▓▓▓▓▓▓▓▓▓▓▓▓▓▓▓▓▓▓▒▒▒▓▓▓▓▒▓▓▓▓▓▓▓▓▓▓▓▓▓▓▓▓▓▓▓▓▓▓▓▓▓▓▓██▓▓▓█▓▓▓▓▓▓▓▓▓▓▓▓▓▓▓▒▒██████████████████████▓████▓▓█
████▓  ░░▒░▒▒▒▒▓▓▓████▒░░░░░░░░░░░░░░░ ░▒▓▓▓▓▒▒▒▒▒▒▓▓▒▒▓▒▒▒▓▓▒▒▒▒▒▒▒▒▓▒▓▒▒▒▓▒▒▓▓▓▓▓▒▒▓▒▒▒▓▓▒▒▒▓▓▓▓▓▓▒▒▒▒▓▓▓▓▓▓▓▒▒▓▓▓▓▓▓▓▓▓▓▓▓▓▓▓▓▓▓▓▓▒▓▓▓▓▓▒▓▓▓▓▓▓▓▓▓▓▓▓▓▓▓▓▓▓▓▓▓▓▓▓▓▓▓▓██▓▓▓█▓▓▓██▓▓▓▓▓█▓▓▓▒▒██████████████████████████████
██▓██░░ ░░░▒░ ░▒▒░░▒▒░░░░░▒▒▒▒▒▒▒░░░░░  ▒▓▓▓▓▒▒▒▒▒▒▒▒▒▒▒▒▒▒▒▒▒▒▒▒▒▒▒▒▓▒▒▒▒▒▓▒▒▓▓▓▒▓▓▓▓▓▒▓▓▓▓▒▓▓▓▓▓▓▓▒▒▒▒▒▓▓▓▒▓▓▓▓▓▓▓▓▒▓▓▓▓▓▓▓▓▓▓▓▓▓▓▓▓▓▓▓▓▓▓▓▓▓▓▓▓▓▓▓▓▓▓▓▓▓▓▓▓▓▓▓▓▓▓▓▓▓▓▓▓▓▓▓██▓▓▓██▓▓█▓█▓▓▓▒▒██████████████████████████████
██░██ ░ ░░ ░░░▒▒░ ░░░░░░░░░▒▒▒▒░░       ▒▓▓▓▓▒▒▒▒▒▒▓▒▒▒▒▓▓▒▒▒▒▒▒▒▒▓▓▒▓▒▓▒▒▓▒▒▓▓▓▒▒▓▓▓▓▓▓▒▓▒▓▓▓▓▓▓▓▓▓▓▓▒▒▒▓▓▓▒▓▓▓▓▓▓▓▓▓▓▓▓▓▓▓▓▓▓▓▓▓▓▓▓█▒▓▓▓▓▒▓▓▓▓▓▓▓▓▓▓▓▓▓▓▓▓▓▓▓▓▓▓▓▓▓▓▓▓▓▓▓▓▓▓▓▓█▓▓█▓▓████▓▓▒▒██████████████████████████████
▒█▒██ ░░░░░░ ░▒░ ░░▒▓▓▓▓▒▒░▒▒▒░░░ ░░░░  ▓████████████████████████████████████████████████████████████████████████████████████████████████████████████████████████████████████████████████████▓██████████████████████████████
█████░    ░░ ░▒░░ ░▒▓▓▓▓▓▒▒▒▒▓▒░░░  ░░ ░▓████████████████████████████████████████████████████████████████████████████████████████████████████████████████████████████████████████████████████▓██████████████████████████████
██████████▓▓▓▓▓▓▒▓███▓▒▒▓▓▓▒▒▒▒▒▒░░░ ░░▒▓████████████████████████████████████████████████████████████████████████████████████████████████████████████████████████████████████████████████████▓██████████████████████████████
███▒█████████████▓▓▓▓▒▒▒▒▒▒▒▒▒▒▒▒░░░░░ ░▓███████████████████████████████████████████████████████████████████████████████████████████████████████████████████████████████████████████████████████████████████████████████████
██░░░█▒░░██░▒██▓░░▒▒▒▒▓▓▒▒▒▒▒▒▒▒▒░ ░░░░░▓███████████████████████████████████████████████████████████████████████████████████████████████████████████████████████████████████████████████████████████████████████████████████
██▓█▓▓▓██▓█▒▒███▒▒▒▒▒▒▓▒▒░░░░▒░░░░░ ░░ ░▓███████████████████████████████████████████████████████████████████████████████████████████████████████████████████████████████████████████████████████████████████████████████████
████████████████▒▒▒▒▒▒░░░░░░░▒░▒▒▒░ ░░░░▓██████████████  ░ ░░▓███████████████████████████████████  ░ ░░▒███████████████████▒██████████░█████████████████████████████████████████████████████████████████████████████████████
░░     ░░▒░ ░░▒▒▒▒▒▓▒▒░ ░░▒▓▒▒▒░░▒░  ░ ░▓██████████████ ▒█████████▓███▓▓████████▓▓████▓▓█████████ ▓█████████▓▓███████▓▓▓███░▒████████▓ ▓██████▓▓████████████████████████████████████████████████████████████████████████████
░▒     ░░  ░░ ░▒▒░▒▒▒▒▒░▒▒▒░░▒▒▒▒▒░ ░░░ ▓██████████████ ░▓▓▓██▓ ▒███▒░███░▒██░ ▓██░ ▒███ ████████ ░▓▓▓▓████████░▓██░▓██████░▓█████████ █████ ███▓ ██████████████████████████████████████████████████████████████████████████
░░     ░░░░  ░▒▒▓▓▒░░░░░▒▒░░░▒░░▒▒░ ░░ ░▓██████████████ ▒█████▓▒███▓░████▓░██░░████ ████ ████████ ▒████████░    ▒██▒ ░▒████░▓█████████ ████░▒████░▒█████████████████████████████████████████████████████████████████████████
░▒     ░░░░░░▒▒▓▓▓▓▓▒▒░▒▒░░░░▒▒▒▒▒░ ░░ ░▓██████████████ ▒█████▓▒████░▓███▒░██░▒████ ████ ████████ ▓███████░▓███▒▒██████░░██░▓█████████ ████░░████░▒█████████████████████████████████████████████████████████████████████████
░░▒▒▒▒▒░▒▓▓█▓▓▓▓▓▒▒▒▒▒▒▒▒▒▒▒▒▒▒▒▒▒░ ░░ ░▓██████████████ ▒█████▓▒█████░▒▒░░███░▒████ ████ ████████  ░░░░▓██▒░▒▒▒░▒██▒▒▒▒░▒██▓░▒▒███████░░▒▒██▒░▒▒░▒███████████████████████████████████████████▓██████████████████████████████
▒▒▒▒▒▒▒░░▒▓█▓▓▓█████▓▒▒▒▒▒▒▒▒▒▒▒▓▒░ ░  ░▒████████████████████████████████████████████████████████████████████████████████████████████████████████████████████████████████████████████████████▓██████████████████████████████
░        ░▒▓██████████▓▒▒░▒▒▒▒▒▒▒▒░░    ▒████████████████████████████████████████████████████████████████████████████████████████████████████████████████████████████████████████████████████▓██████████████████████████████
▒░░░░░░░░░▒▒▓▒▒▓▓███████████▓▓▓▓▓█▓░    ▒████████████████████████████████████████████████████████████████████████████████████████████████████████████████████████████████████████████████████▓██████████████████████████████
▒▒▒▒▒▓░░░▒▓▓████▓▓▓███▓▓▓▓▓▓▓▓▓▓▒▒▒░░░░ ▒████████████████████████████████████████████████████████████████████████████████████████████████████████████████████████████████████████████████████▓██████████████████████████████
░░░░▒▒░░░▒▓▓████████▒▓████▓▓▓▒▒▒▒▒▒▒▒░░░▒████████████████████████████████████████████████████████████████████████████████████████████████████████████████████████████████████████████████████▓██████████████████████████████
    ░░   ░▒░▒▓▒▓▓▓▓██▓▒▒▒▒▒▒▒▓▓▓▓▓▒▒▒░░░▒██▒█████░▒████▒▓███████████████████████████████████████ ██████████████████████▒▓████████████████████████████████████████████████████████████████████▒██████████████████████████████
░░░░  ░ ░▒▒░▒████▓▓▒▒▒▓▓▓▓▓▒▒▒▒▒▒▒░░░░░░▒██▒ ███▒  ████ ██████████████████▒░██████████████ █████ ██████████████████████▒▓████████████████████████████████████████████████████████████████████▓██████████████████████████████
        ░▒▒░░▒██▓█▓▓▓▓▒▒▒▒▒▒▒▒▒░░▒▒░░░░░▒███ ███ █▒▒██▒▒██▒▒▓▓▒▒██▓░▓█▓▓██░ ▒▓███████████▓ ▒▓███ ░▓▓▒ ▓███░▒█▓░▒███████░░▒▓▓ ▒███░▒▓█▒░███▓▓█▓▒▒███░████▒▒██▓░▓█▒░███░░▒▓▓ ▒██▒░▓█▓▓█████████▓██████████████████████████████
           ░░▒▒▓▓▓▓▒▒▒▒▒▒▒░▒▒░░▒▒▒▒▒▒░  ▒███░░█▓░██ ██ ██▒░███▓░▒█▓░▓█████▒░██████████████ █████ ▓███▓░██ ░███▒ ▓██████▒▒████ ██░ ████░░███▓▓▒▒ ▒██▒▒██▓░██▓░▓███▒░██░▒███▓ ██▒░▓████████████▓██████████████████████████████
           ░▒▒▒▒▓▓▒▒▒▒▒▒▒░░░░▒▓▓▒▒▒▒▒░░░▒████ █ ███▒▒▒░██▒░██████████▓▒░██▒░██████████████ █████ ████▓▒██ ▒████████████░▓████ ██░ ████████ ████ ▒███░▒█░▓██▓░▓███████░▓███▓ █████▓▒░█████████▓██████████████████████████████
           ▒░▒▒▒▒▒▒▒░▒░░░▒▓▓▒▒▒▓▒▒▒▒░░░░▒████  ░████  ▓███░▒███▓██████▓░███░▒████▒████████░░████ ████▓░██▓░▓███████████▒▓████ ███░▒███████ ▓██▒ ▒████░░▒████▒▒███████░▓███▓ ██▓███▓ █████████▓██████████████████████████████
           ░░░▒▓▒▒░░░░▒▓██▒▒▒░░░░░░░░▒░░▒███████████████████▓▓▓█████▓▓██████████▓░██████████████████████████▓▓█████████████████████▓▓▓██████▓██████████████████▓▓███████████████▓▓███████████▓██████████████████████████████
           ░░░▒░░░▒▓▒▓▓▒▒▒▒▒▒░░▒▒▒░░▒▒░░▒████████████████████████████████████████████████████████████████████████████████████████████████████████████████████████████████████████████████████▓███████▓███▓██████████████████
       ░░░░░░░░░░▒▒▒▒░░ ░▒▒▒▒▒▒▒░░░░░░░░▒████████████████████████████████████████████████████████████████████████████████████████████████████████████████████████████████████████████████████▓██████████████████████████████
░   ░░░░░░░░░░▒▒▒▒▒▒▒▒     ░▒▒▒▒▒▒░░   ░▒████████████████████████████████████████████████████████████████████████████████████████████████████████████████████████████████████████████████████▓██████████████████████████████
░   ░░▒▒▒░  ░░░▒▒▒▒▒░░░░░░░░░░░░ ░░░░░░ ▒████████████████████████████████████████████████████████████████████████████████████████████████████████████████████████████████████████████████████▓██████████████████████████████
    ░░░▓▒▒░░  ░░░░░░░░░░▒▒▒▒░░░░░▒▒░░░░░▒██████████████████████▓██████████████████████████████████████████████████████████████████████████████████▓██████████████████████████████████████████▓██████████████████████████████
   ░░░░▓▒▒░▒░░░░▒░░  ░░░▒░░░░  ░░  ░░░  ▒███████████████████████████████▒▓█████████████████████  ▓▓▓▓█████████████░▓████████████████████████ ▓████░██████████████████████████████████████████▒▒▒▒▒▒▒▒▒▒▒▒▒▒▒▒▒▒▓▓▓▓▓▓▓▓▓▓███
     ░░▒▒░░░░░░░   ░░░ ░░░░░ ░░░░░░░░░░ ▓███▓░▒▒▒▒▓██▒▓████▒███▒███▓▒▒▒▒░▓███▓▒▒▒▒█████████████ ░████████▒▓▒▒░▓██▒ ░▒▒███▒▒▒▒▓███░▓▒▒▒█████▒ ░▒▓██░▒▒▒░▒████▓▒▒▒▒████████████████████████████▒░▒████████████████████████████
░    ░░▒░░░░░░     ░          ░░░░░░░░░░▓██▒ ████ ▒██░▒███▓░██▓░██▓░████░▓██░▓████ ████████████  ░░░░▒███░████ ▓██░▓███▒░████░▒██ ░█████████ ▓████ ▒███▒▒██░▒███▓░███████████████████████████▒▓▓████████████████████████████
░░░  ░░░░░░░░░░░░ ░░░░░░░░░░░▒▒▒░░░░░░░ ▓██ ▒████ ▒██░▒███▓░██▓░██▒▒████▒▓██░░░░░░░████████████ ░████████▒████░▓██░▓███▒ ░░░░░▒██ ██████████ ▓████░████▒▒█▓  ░░░░░███████████████████████████▓▓▓██▒░░░░░░░░░░░░░░░░░░░░░░░▒▒
 ░ ░░░░░ ░  ░░░░░░░▒░░░░░▒░░░░ ░░░░░░░  ███▓ ████ ▒██▒░███▒░██▓░██▓░████ ▓██░▒█████████████████ ░████████▒████░▓██░▓███▓ ████████ ██████████ ▓████░████▒▒██░▒████████████████████████████████▓▓▒██▒░░▒░░░░░░░░░░░░░░░░░░░░▒▒
▒░░  ░░ ░▒▒▒░░░░░░░░░▒░▒░   ░░░░░       █████▒░▒█ ▒███▒  ▒▓▒███▒████▒ ░▓▒▓███▓░  ░▒███░████████▒░░░░░▒███▒████▒▓███▒░░███▒   ▒███░███████████▒░▒██▒████▓▓████░  ░▓███████████████████████████▒▒▒▓█▒░░░░░░░░░░░░░░░░░░░▒░░░▒▒
░░░░░░ ░ ░░     ░░░░░░░░░░░░░░░ ░░   ░  ████▓███░ ███████████████████████████████████████████████████████████████████████████████████████████████████████████████████████████████████████████▒░░▓█▒░░░░░░░░░░░░░░░░▒░░░░░▒▒▒
░░░░░░░░░░░░░░ ░░░░░░░░░░░░░░░░░░░░░░   █████████████████████████████████████████████████████████████████████████████████████████████████████████████████████████████████████████████████████▒░░▓█▒░░░░░░▒▒▒▒▒▒▒▒▒▒▒▒▒▒▒▒▒▒▒
░░░░░░░░▒░░ ░░░▒▒▒▒▓▓▒░░░░▒▒▒▒▒▒░░░     █████████████████████████████████████████████████████████████████████████████████████████████████████████████████████████████████████████████████████▒░░▓█▒░░░░░░▒▒▒▒▒▒▒▒▒▒▒▒▒▒▒▒▒▒▓
 ░░░░  ░░░░░░░▒████████▓▒▒▓█▓▓▓▓▓▓▒     █████████████████████████████████████████████████████████████████████████████████████████████████████████████████████████████████████████████████████▒░░▓█▒░░░░░░▒▒▒▒▒▒▒▒▓▒▒▒▒▒▒▒▓▒▒
░ ░░░░░░░░░░░░░░░▒▒▒▒▒▒░░▒▒▓▓▓▒▓▒▒▒░    █████████████████████████████████████████████████████████████████████████████████████████████████████████████████████████████████████████████████████▒░░▓█▒░░░░░░▒▒▒▒▒▒▒███▓█▒▒███▓█
░░░░░░░░░░░░░▒████████▓▓▒░▓█▓█▒▒▒▒▒░    ████████████████████████▒▒██████████████████████▒▒█████████████████████████████░████████▓▒███████████ █████████████▒▓████░███████████████████████████▒░░▓█▒░░░░░░▒▒▒▒▒▒▒▓▒▓▓▓▒▒▓▒▓▒█
░░░ ░░░░  ░░░░▒██▓██▓█▓█▓░▓█▓▓▓▓▓▓▓░    █████▓▒▒█████▓██▒▓██▓▒▓█▒▒████▓▒▓███████▓▒███████▓███▓█▓▒▓█████████████▓███████░▓█▒▒█████▓█████▒▒▓███ ██▒▒████████▓ ░▓▓██░▓█▒▒██████▓▒▒████▓█████████▒░░▓█▒░░░░░░▒▒▒▒▓▓▓▓▓▓▓▓▓▓▓▓▒▒▒
 ░░░░░░░  ░░░░░░░░░▒░░░░░░▒▒▒▒░▒░░░░░░  ████ ███▓ ███ ░███▓ ▓██▓ ▒██▒▒███▒░██░ ▓████████░ ██▓ ▓███ ███████▓▒██▒ ▒██▒▓██░░███░▒██▒ ██▓ ███████ ░███░▒███████░▒████░▒███░▓██▒░███▓ ██▒ ███▓ ███▒░░▓█▒░░░░░░▒▒▒▓████▓██▒████▓██
░░░░░░░░░  ░░░░░░░░░░░░░░░░░░░░         ███ ▒████░░██ ▓███▒▒████▒▒█▓  ░░░  ██░░█████████░ ██▓ ████ ▒███████░▓▓▒▓▒▓▓░███░████░░██▒ ██ ▒███████ ████▒░███████░▒████░████▒▒██  ░░░░ ▓██░▒██ ████▒░░▓█▒░░░░░░▒▒▒▒▒█████████▓▓▒█▓
▒▒▒▒▒▒▒▒▒▒▒▒▒▒▒▒▒▒▒▒▒▒▒▒▒░░░░░░░░░░░  ░░███░░████ ▒██ ████▓░████░▒██░▓███████░░█████████░ ██▓ ████ ▒███████▓░▒▓█▓▒░▓███░████▒░██▒ ██ ░███████ ████▒░███████░▒████░████▒▒██ ▓█████████ ▓░▒████▒▒░▓█▒░░░░░░▒▒▒▒▒▒▓██▓▓███▒█▒▒▒
▓▓▓▓▓▓▓▓▓▓▓▓▓▓▓▓▓▓▓▓▓▓▓▓▓▓▓▓▒▒▒▒▒▒▒▒▒▒▒▒████▒░▒▒░▒███ █████▒░▒▒▒░▒███▒░▒▒▒▒██░░█████████░ ██▓ ████ ▒████████ ░███░ ████░████░░██▒ ███▒░▒▒▒▓██ ████▒░███████▓░░▒██░████▒▒███▒░▒▒▒▒█████ ░█████▒░░▓█▒░░░░░░▒▒▒▒▒▒▒█▓▓▓██▓▒▓▒▒▒
██████████████████████████▓▓▓▓▓▓▒▒▒▒▒▒▒▒█████████████████████████████████████████████████████████████████████████████████████████████████████████████████████████████████████████████▓ ██████▒▒░██▒░░░░░░▒▒▒▒▒████▓▓████▓▒▒▒
████████████████████████████████████▓▓▓▓███████████████████████████████████████████████████████████████████████████████████████████████████████████████████████████████████████████▓▒▒███████▒▒░██▒░░░░░░▒▒▒▒▒███▒▒▒▒███▒▒▒▒
██████████████████████████████████▓▓▓▓▓▓█████████████████████████████████████████████████████████████████████████████████████████████████████████████████████████████████████████████████████▒▒░██▒░░░░░░▒▒▒▒▒▒▒▒▒▒▒▒▓▒▒▒▒▒▒
█████████████████████████████████▓▓▓▓▓▓▓█████████████████████████████████████████████████████████████████████████████████████████████████████████████████████████████████████████████████████▓▒░██░░░░░░░▒▒▒▒▒▒▒▒▒▒▒▒▒▒▒▒▒▒▒
██████████████████████████████████▓▓▓▓▓▓█████████████████████████████████████████████████████████████████████████████████████████████████████████████████████████████████████████████████████▒▒▒██░░░░░░░▒▒▒▒▓█▓▓█▒▓██▒▒███▓
▓███▓▓▓▓▓▓████▓█▓████▓▓████████████▓▓▓▓▓██████████████████████████▓░████████░████████████████████████████████████████████████████████████████████████████████████████████████████████████████▓▒▒██░░░░░░░▒▒▒▒▒▒▒▒▒▒▒▒▒▒▒▒▒▒▒
▓████▓██▓██▓▓▓██▓▓▓██▓█▓███████████▓▓▓▓█████████████████████████████████████░████████████████████████████████████████████████████████████████████████████████████████████████████████████████▒▒▒██▒░░░░░░▒▒▒▒▓█▓▒▓▓▓▓█▓▒█▓▓▒
███████████████████████████████████▓▓▓▓█████ ░▓███░▒██▒▒██▓░▓█████▒░███░▒██▒ ███▒░▓█▓░▒██████████████████████████████████████████████████████████████████████████████████████████████████████▓▒▒██▒░░░░░░▒▒▒▒▒▒▓▓▓▓▒▒▓▓▒▒▒▒▒
███████████████████████████████████▓▓▓▓█████ ████ ░▓▓▓▓░▒█▓░▒█████▒░██▒▒████░███ ▒▓▓▓▒ ██████████████████████████████████████████████████████████████████████████████████████████████████████▓▒▒██▒░░░░░░▒▒▒▒▓▒▒▓▓▒▒▒▒▒▒▒▒▒▒
███████████████████████████████████▓▓▓▓█████ ████ ░██████████▓▒░██▒░██▒▒████░███ ▓███████████████████████████████████████████████████████████████████████████████████████████████████████████▓▓▒██▒░░░░░▒▒▒▒▒▓▓▓▓█▓▓▓█▓▓▓█▓▒
██░▒▓ █░██░██▒▒██▓░▒█▒▒▒ ▒▒▒▒░▒▒▓██▓▓▓▓█████ █████░▒███▓███▓██▒░██▒░███░▒██▒ ███▒░▓███▓███░██████████████████████████████████████████████████████████████████████████████████████████████████▓▓▒██▒▒▒▒▒▒▒▒▒▒▒▒▒▒▒▒▓▒▒▒▒▒▒▒▒▒
██▒░▓██░▒▓░██▒▒███░▓█▒▒▒▒▒░░▒░▒░░██▓▓▓▓██████████████████████████████████████████████████████████████████████████████████████████████████████████████████████████████████████████████████████▓▓▓██▒▒▒▒▒▒▒▒▒▒▒▓████▓▓█████▒▒▓
██████████████████████████████▓▓██▓▓▓▓▒▒▓████████████████████████████████████████████████████████████████████████████████████████████████████████████████████████████████████████████████████▓▓▓██▓▒▒▒▒▒▒▒▒▒▒▒▒▒▒▒▒▒▒▒▒▒▒▒▒▒
██████████████████████████████████▓▓▓▓▓▓▓████████████████████████████████████████████████████████████████████████████████████████████████████████████████████████████████████████████████████▓▓▓███▓▓▓▒▒▒▒▒▒▒▒▒▒▒▒▒▒▒▒▒▒▒▒▒▒