▒▒▒▒▒▒▒▒▒▒▒▒▒▒▒▒▒▒▒▒▒▒▒▓▓▓▓▓▓▓▓▓▓▓▓▓▓▓▓▓▓▓▓▓▓▓▓▓▓▓▓▓▓▓▓▓▓▓▓▓▓▓▓▓▓▓▓▓▓▓▓▓▓▓▓▓▓▓▓▓▓▓▓▓▓▓▓▓▓▓▓▓▓▓▓▓▓▓▒▒▒▒▒▒▒▒▒▒▒▒▒▒▒▒▒▒▒▒▒▒▒▒▒▒▒▒▒▒▒▒▒▒▒▒▒▒▒▒▒▒▒▒▒▒▒▒▒▒▒▒▒▒▒▒▒▒▒▒▒▒▒▒▒▒▒▒▒▒▒▒▒▒▒▒▒▒▒▒▒▒▒▒▒▒▒▒▒▒▒▒▒▒▒▒▒▒░░░░░░░░░░░░░░░░░░░░░░░░
▒▒▒▒▒▒▒▒▒▒▒▒▒▒▒▒▒▒▓▓▓▓▓▓▓▓▓▓▓▓▓▓▓▓▓▓▓▓▓▓▓▓▓▓▓▓▓▓▓▓▓▓▓▓▓▓▓▓▓▓▓▓▓▓▓▓▓▓▓▓▓▓▓▓▓▓▓▓▓▓▓▓▓▓▓▓▓▓▓▓▓▓▓▓▓▓▓▓▓▓▓▓▒▓▓▓▒▒▒▒▒▒▒▒▒▒▒▒▒▒▒▒▒▒▒▒▒▒▒▒▒▒▒▒▒▒▒▒▒▒▒▒▒▒▒▒▒▒▒▒▒▒▒▒▒▒▒▒▒▒▒▒▒▒▒▒▒▒▒▒▒▒▒▒▒▒▒▒▒▒▒▒▒▒▒░░░░░░░░░░░░░░░░░░░░░░░░░░░░░░░░░░░
▓▓▓▓▓▓▓▓▓▓▓▓▓▓▓▓▓▓▓████████████████████████████████████████████████████████▓▓▓▓▓▓▓▓▓▓▓▓▓▓▓▓▓▓▓▓▓▓▓▓▓▓▓▓▓▓▓▓▓▓▓▓▓▓▓▓▓▓▓▓▓▓▓▓▓▓▓▓▓▓▓▓▓▓▓▓▓▓▓▓▓▓▓▓▓▓▓▓▓▓▓▓▓▓▓▓▒▒▒▒▒▒▒▒▒▒▒▒▒▒▒▒▒▒▒▒▒▒▒▒▒▒▒▒▒▒▒▒▒▒▒▒░░░░░░░░░░░░░░░░░░░░░░░░░░░░░
▓▓▓▓▓▓▓▓▓▓▓██████████████████████████████████████████████████████████████████████████████▓▓▓▓▓▓▓▓▓▓▓▓▓▓▓▓▓▓▓▓▓▓▓▓▓▓▓▓▓▓▓▓▓▓▓▓▓▓▓▓▓▓▓▓▓▓▓▓▓▓▓▓▓▓▓▓▓▓▓▓▓▓▓▓▓▓▓▓▓▓▓▓▓▓▓▒▒▒▒▒▒▒▒▒▒▒▒▒▒▒▒▒▒▒▒▒▒▒▒▒▒▒▒▒▒▒░░░░░░░░░░░░░░░░░░░░░░░░░
▓▓▓▓▓▓▓▓█████████████████████████████████████████████████████████████████████████████████████████████▓▓▓▓▓▓▓▓▓▓▓▓▓▓▓▓▓▓▓▓▓▓▓▓▓▓▓▓▓▓▓▓▓▓▓▓▓▓▓▓▓▓▓▓▓▓▓▓▓▓▓▓▓▓▓▓▓▓▓▓▓▓▓▓▓▓▒▒▒▒▒▒▒▒▒▒▒▒▒▒▒▒▒▒▒▒▒▒▒▒▒▒▒▒▒▒▒░░░░░░░░░░░░░░░░░░░░░░
▓▓▓▓▓▓████████████████████████████████████████████████████████████████████████████████████████████████████████▓▓▓▓▓▓▓▓▓▓▓▓▓▓▓▓▓▓▓▓▓▓▓▓▓▓▓▓▓▓▓▓▓▓▓▓▓▓▓▓▓▓▓▓▓▓▓▓▓▓▓▓▓▓▓▓▓▓▓▓▓▒▒▒▒▒▒▒▒▒▒▒▒▒▒▒▒▒▒▒▒▒▒▒▒▒▒▒▒▒░░░░░░░░░░░░░░░░░░░░
▓▓▓▓▓███████████████████████████████████████████████████████████████████████████████████████████████████████████████▓▓▓▓▓▓▓▓▓▓▓▓▓▓▓▓▓▓▓▓▓▓▓▓▓▓▓▓▓▓▓▓▓▓▓▓▓▓▓▓▓▓▓▓▓▓▓▓▓▓▓▓▓▓▓▓▓▓▓▒▒▒▒▒▒▒▒▒▒▒▒▒▒▒▒▒▒▒▒▒▒▒▒▒▒░░░░░░░░░░░░░░░░░░░
▓▓▓▓███████████████████████████████████████████████████████████████████████████████████████████████████████████████████▓▓▓▓▓▓▓▓▓▓▓▓▓▓▓▓▓▓▓▓▓▓▓▓▓▓▓▓▓▓▓▓▓▓▓▓▓▓▓▓▓▓▓▓▓▓▓▓▓▓▓▓▓▓▓▓▓▓▒▒▒▒▒▒▒▒▒▒▒▒▒▒▒▒▒▒▒▒▒▒▒▒▒▒░░░░░░░░░░░░░░░░░
▓▓▓██████████████████████████████████████████████████████████████████████████████████████████████████████████████████████▓▓▓▓▓▓▓▓▓▓▓▓▓▓▓▓▓▓▓▓▓▓▓▓▓▓▓▓▓▓▓▓▓▓▓▓▓▓▓▓▓▓▓▓▓▓▓▓▓▓▓▓▓▓▓▓▓▓▓▒▒▒▒▒▒▒▒▒▒▒▒▒▒▒▒▒▒▒▒▒▒▒▒░░░░░░░░░░░░░░░░
▓▓██████████████████████████████████████████████████████████████████████████████████████████████████████████████████████████▓▓▓▓▓▓▓▓▓▓▓▓▓▓▓▓▓▓▓▓▓▓▓▓▓▓▓▓▓▓▓▓▓▓▓▓▓▓▓▓▓▓▓▓▓▓▓▓▓▓▓▓▓▓▓▓▓▒▒▒▒▒▒▒▒▒▒▒▒▒▒▒▒▒▒▒▒▒▒▒▒░░░░░░░░░░░░░░░
▓█████████████████████████████████▓▓▓▓▓▓▓▓▓▓▓▓▓▓▓▓▓▓▓▓▓▓▓▓▓▓▓▓▓▓▓▓▓▓▓▓▓▓▓▓▓▓▓▓▓▓▓█████████████████████████████████████████████▓▓▓▓▓▓▓▓▓▓▓▓▓▓▓▓▓▓▓▓▓▓▓▓▓▓▓▓▓▓▓▓▓▓▓▓▓▓▓▓▓▓▓▓▓▓▓▓▓▓▓▓▓▓▓▓▓▒▒▒▒▒▒▒▒▒▒▒▒▒▒▒▒▒▒▒▒▒▒▒░░░░░░░░░░░░░░
██████████████████████████████████▓▓██████████████████████████████████████████▒░░▒▓█████████████████████████████████████████▓▓▓▓▓▓▓▓▓▓▓▓▓▓▓▓▓▓▓▓▓▓▓▓▓▓▓▓▓▓▓▓▓▓▓▓▓▓▓▓▓▓▓▓▓▓▓▓▓▓▓▓▓▓▓▓▓▓▓▓▒▒▒▒▒▒▒▒▒▒▒▒▒▒▒▒▒▒▒▒▒▒▒░░░░░░░░░░░░░
██████████████████████████████████▓▓▓▓▒▒▒▒▒▒▒▒▒▒▒▒▒▒▒▒▒▒▒▒▒▒▒▒▒▒▒▒▒▒▒▒▒▒▒▒▒▓▓█▒░░▒▓▓▓██████████████████████████████▓▒▒▒▒▒▒▒▒▒▒▒▒▒▒▒▒▒▒▒▒▒▒▒▒▒▒▒▒▒▒▒▒▒▒▒▒▒▒▒▒▒▒▒▒▒▒▒▒▒▒▒▒▒▒▒▒▒▒▒▒▒▒▒▒▒▒▒▒▓▒▒▒▒▒▒▒▒▒▒▒▒▒▒▒▒▒▒▒▒▒▒▒░░░░░░░░░░░░
██████████████████████████████████▓▓▓▓▒░░░░░░░░░░░░░░░░░░░░░░░░░░░░░░░░░░░▒▓▓█▒░░▒▓▓▓██████████████████████████████▓░░░░░░░░░░░░░░░░▒▒░░░░░░░░░░░░░░░░░░░░░░░▓░░░░░░░░░░░░░░░░░░░░░░░░▒▒▒▒▒▒▒▒▒▒▒▒▒▒▒▒▒▒▒▒▒▒▒▒▒▒░░░░░░░░░░░░
██████████████████████████████████▓▓▓▓▒░░░░▒▒▒▓▓▓▓▓▓▓▓▓▓▓▓▓▓▓▓▓▓▓▓▓▓▓▓▓▓▓▓▓▓▓█▒░░▒▓▓▓██████████████████████████████▓░░░░░░░░░░░░░░░░▒▒░░░░░░░░░░░░░░░░░░░░░░▒▓░░░░░░░░░░░░░░░░░░░░░░▒▓▓▒▒▒▒▒▒▒▒▒▒▒▒▒▒▒▒▒▒▒▒▒▒▒▒▒░░░░░░░░░░░░
██████████████████████████████████▓▓▓▓▒░░░▒▒▓▓▓███████████████████████████▓▓▓█▒░░▒▓▓▓██████████████████████████████▓░░░░░░░░░░░░░░░░▒▒░░░░░░░░░░░░░░░░░░░░░░▓▓░░░░░░░░░░░░░░░░░░░░░▒▓▓▓░░░▒▒▒▒▒▒▒▒▒▒▒▒▒▒▒▒▒▒▒▒▒▒░░░░░░░░░░░░
██████████████████████████████████▓▓▓▓▒░░░▒▓▓▒▒▒▓▓▓▓▓▓▓▓▓▓▓▓▓▓▓▓▓▓▓▓▒▒▓███▓▓▓█▒░░▒▓▓▓██████████████████████████████▓░░░░░░░░░░░░░░░░▒▒░░░░░░░░░░░░░░░░░░░░░▒▓▓░░░░░░░░░░░░░░░░░░░░▒▓▓█▓░░░░░░░░░▒▒▒▒▒▒▒▒▒▒▒▒▒▒▒▒░░░░░░░░░░░░
██████████████████████████████████▓▓▓▓▒░░░▒▓▓▒▒▓███████████████████▓▓▓▓███▓▓▓█▒░░▒▓▓▓██████████████████████████████▓░░░░░░░░░░░▒▒▒▒▒▒▒░░░░░░░░░░▒▒▒▒▒▒▒▒▒▒▒▓▓█░░░░▒░▒░▒▒░░▒▒▒░░░▒▒▒▓██▓░░░░░░░░░░░░░░░░▒▒▒▒▒▒▒▒▒░░░░░░░░░░░░
██████████████████████████████████▓▓▓▓▒░░░▒▓▓▒▒▓███████████████████▓▓▓▓███▓▓▓█▒░░▒▓▓▓██████████████████████████████▓░░░░░░░░░▒▒▒▒▒▒▒▓▒░░░░░░░░▒▒▒▒▒▒▒▓▓▓▓▓▓▓██░░░░▓▒▓▓▓█▓▓█▓▓▓▓▓▓▓▓▒██▓░░░░░░░░░░░░░░░░░░░░▒▒▒▒▒░░░░░░░░░░░░
██████████████████████████████████▓▓▓▓▒░░░▒▓▓▒▒▓███████████████████▓▓▓▓███▓▓▓█▒░░▒▓▓▓██████████████████████████████▓░░░░░░░░░▒▒▒▒▓▓▓▓▒░░░░░░░░▒▒▒▒▓▓▓▓▓▓▓▓▓███░░░░▓▒▓▓▓█▓▓█▓▓▓▓█▓▓▓▒██▓░░░░░░░░░░░░░░░░░░░░░░░░░░░░░░░░░░░░░
██████████████████████████████████▓▓▓▓▒░░░▒▓▓▒▒▓███████████████████▓▓▓▓███▓▓▓█▒░░▒▓▓▓██████████████████████████████▓░░░░░░░░▒▒▒▒▓▓▓▓▓▒░░░░░░░▒▒▒▒▓▓▓▓▓▓▓▓▓▓███░░░░▓▒▓▓▓█▓▓█▓▓▓▓▓▓▓▓▒██▓░░░░░░░░░░░░░░░░░░░░░░░░░░░░░░░░░░░░░
██████████████████████████████████▓▓▓▓▒░░░▒▓▓▒▒▓███████████████████▓▓▓▓███▓▓▓█▒░░▒▓▓▓██████████████████████████████▓░░░░░░░░▒▒▒▒▒▓▓▓▓▒░░░░░░░▒▒▒▒▒▓▓▓▓▓▓▓▓▓▓▓▓░░░░▒▒▓▒▓▓▓▓▓▒▓▒▓▓▓▓▓▒▓▓▒░░░░░░░░░░░░░░░░░░░░░░░░░░░░░░░░░░░░░
██████████████████████████████████▓▓▓▓▒░░░▒▓▓▒▒▓███████████████████▓▓▓▓███▓▓▓█▒░░▒▓▓▓██████████████████████████████▓░░░░░░░░░░░░░░░░▒▒░░░░░░░░░░░░░░░░░░░░░░░▓░░░░░░░░░░░░░░░░░░░░░░░▒▒░░░░░░░░░░░░░░░░░░░░░░░░░░░░░░░░░░░░░
██████████████████████████████████▓▓▓▓▒░░░▒▓▓▒▒▓███████████████████▓▓▓▓███▓▓▓█▒░░▒▓▓▓██████████████████████████████▓░░░░░░░░░░░░░░░░▒▒░░░░░░░░░░░░░░░░░░░░░░▒▓░░░░░░░░░░░░░░░░░░░░░░▒▓▒░░░░░░░░░░░░░░░░░░░░░░░░░░░░░░░░░░░░░
▓█████████████████████████████████▓▓▓▓▒░░░▒▓▓▒▒▓███████████████████▓▓▓▓███▓▓▓█▒░░▒▓▓▓██████████████████████████████▓░░░░░░░░░░░░░░░░▒▒░░░░░░░░░░░░░░░░░░░░░▒▓▓░░░░░░░░░░░░░░░░░░░░░▒▓▓▓░░░░░░░░░░░░░░░░░░░░░░░░░░░░░░░░░░░░░
▓▓████████████████████████████████▓▓▓▓▒░░░▒▓▓▒▒▓███████████████████▓▓▓▓███▓▓▓▓▒░░▒▓▓▓██████████████████████████████▓░░░░░░░░░░░░▒▒▒▒▒▒░░░░░░░░░░░▒▒▒▒▒▒▒▒▒▒▓▓▓░░░░░░▒░░░░░░░░░░░░▒▒▓██▓░░░░░░░░░░░░░░░░░░░░░░░░░░░░░░░░░░░░░
▓▓▓███████████████████████████████▓▓▓▓▒░░░▒▓▓▒▒▓███████████████████▓▓▓▓███▓▓▓▓▒░░▒▓▓▓██████████████████████████████▓░░░░░░░░░▒▒▒▒▒▒▒▓▒░░░░░░░░▒▒▒▒▒▒▒▒▒▒▓▓▒▓██░░░░▒▒▓▒▓▓▓▒▓▒▓▓▒▓▒▓▓▓██▓░░░░░░░░░░░░░░░░░░░░░░░░░░░░░░░░░░░░░
▓▓▓▓██████████████████████████████▓▓▓▓▒░░░▒▓▓▒▒▓███████████████████▓▓▓▓███▓▓▓▓▒░░▒▓▓▓▓█████████████████████████████▓░░░░░░░░▒▒▒▒▒▓▓▓▓▒░░░░░░░▒▒▒▒▒▓▓▓▓▓▓▓▓▓▓██░░░░▒▒▓▒▓█▓▓█▓█▓▓▓▓▓▒▒██▓░░░░░░░░░░░░░░░░░░░░░░░░░░░░░░░░░░░░░
▓▓▓▓▓▓███████████████████████████▓▓▓▓▓▒░░░▒▓▓▒▒▓███████████████████▓▓▓▓███▓▓▓▓▒░░▒▓▓▓▓█████████████████████████████▓░░░░░░░░▒▒▒▒▓▓▓▓▓▒░░░░░░░▒▒▒▒▓▓▓▓▓▓▓▓▓▓███░░░░▒▒▓▒▓▓▓▓█▓▓▓▓▓▓▓▒▓██▓░░░░░░░░░░░░░░░░░░░░░░░░░░░░░░░░░░░░░
▓▓▓▓▓▓▓▓█████████████████████████▓▓▓▓▓▒░░░▒▓▓▒▒▓███████████████████▓▓▓▓███▓▓▓▓▒░░▒▓▓▓▓█████████████████████████████▓░░░░░░░░▒▒▒▒▓▓▓▓▓▒░░░░░░░▒▒▒▒▓▓▓▓▓▓▓▓▓▓█▓▓░░░░▒▒▓▒▓▓▓▓█▓▓▓▓▓▓▓▒▓██▓░░░░░░░░░░░░░░░░░░░░░░░░░░░░░░░░░░░░░
▓▓▓▓▓▓▓▓▓▓███████████████████████▓▓▓▓▓▒░░░▒▓▓▒▒▓███████████████████▓▓▓▓███▓▓▓▓▒░░▒▒▓▓▓█████████████████████████████▓▒▓▓▓▓▓▓▓▓▓▓▓▓▓▓▓▓▓▓▓▓▓▓▓▓▓▓▓▓▓▓▓▓▓▓▓▓▓▓▓▒▓▒▒▓▓▓▓▓▓▓▓▓▓▓▓▓▓▓▓▓▓▓▓▓▓▒░░░░░░░░░░░░░░░░░░░░░░░░░░░░░░░░░░░░░
▓▓▓▓▓▓▓▓▓▓▓▓▓████████████████████▓▓▓▓▓▒░░░▒▓▓▒▒▓███████████████████▓▓▓▓███▓▓▓▓▒░░▒▒▓▓▓█████████████████████████████▓░░░░░░░░░░░░░░░░▒▒░░░░░░░░░░░░░░░░░░░░░░▒▓░░░░░░░░░░░░░░░░░░░░░░░▒▒░░░░░░░░░░░░░░░░░░░░░░░░░░░░░░░░░░░░░
▓▓▓▓▓▓▓▓▓▓▓▓▓▓▓██████████████████▓▓▓▓▓▒░░░▒▓▓▒▒▓███████████████████▓▓▓▓███▓▓▓▓▒░░▒▒▓▓▓▓████████████████████████████▓░░░░░░░░░░░░░░░░▒▒░░░░░░░░░░░░░░░░░░░░░▒▓▓░░░░░░░░░░░░░░░░░░░░░░▒▓▓░░░░░░░░░░░░░░░░░░░░░░░░░░░░░░░░░░░░░
▓▓▓▓▓▓▓▓▓▓▓▓▓▓▓▓▓▓▓██████████████▓▓▓▓▓▒░░░▒▓▓▒▒▓███████████████████▓▓▓▓███▓▓▓▓▒░░▒▒▓▓▓▓████████████████████████████▓░░░░░░░░░░░▒▒▒▒▒▒▒░░░░░░░░░░░░▒▒▒▒▒▒▒▒▒▓▓▓░░░░░░░░░░░░░░░░░░░░▒▓▓█▓░░░░░░░░░░░░░░░░░░░░░░░░░░░░░░░░░░░░░
▓▓▓▓▓▓▓▓▓▓▓▓▓▓▓▓▓▓▓▓▓▓▓██████████▓▓▓▓▓▒░░░▒▓▓▒▒▓███████████████████▓▓▓▓███▓▓▓▓▒░░▒▒▓▓▓▓▓███████████████████████████▓░░░░░░░░░▒▒▒▒▒▒▒▓▒░░░░░░░░░▒▒▒▒▒▒▒▒▒▒▒▒▓█▓░░░░░░░░░▒▓▒▓▒▒▓▒▓▓▓▒▒▓█▓░░░░░░░░░░░░░░░░░░░░░░░░░░░░░░░░░░░░░
▓▓▓▓▓▓▓▓▓▓▓▓▓▓▓▓▓▓▓▓▓▓▓▓▓▓▓██████▓▓▓▓▓▒░░░▒▓▓▒▒▓▓▓▓▓▓▓▓▓▓▓▓▓▓▓▓▓▓▓▓▓▓▓▓▓▓▓▓▓▓▓▒░░▒▒▓▓▓▓▓▓██████████████████████████▓░░░░░░░░▒▒▒▒▒▓▓▓▓▒░░░░░░░░▒▒▒▒▓▓▓▓▓▓▓▓▓▓█▓░░░░░▒▓▓▒▓▓▓█▓▓█▓▓▓█▓░▓█▓░░░░░░░░░░░░░░░░░░░░░░░░░░░░░░░░░░░░░
▒▒▓▓▓▓▓▓▓▓▓▓▓▓▓▓▓▓▓▓▓▓▓▓▓▓▓▓▓▓▓▓▓▓▓▓▓▓▒░░░▒▓▓▒▒▓▓▓▓▓▓▓▓▓▓▓▓▓▓▓▓▓▓▓▓▓▓▓▓█▓▒▓▓▓▓▒░░▒▒▓▓▓▓▓▓▓▓███████████████████████▓▓░░░░░░░░▒▒▒▒▒▓▓▓▓▒░░░░░░░▒▒▒▒▒▓▓▓▓▓▓▓▓▓██▓░░░░░▒▓▓▒▓▓▓█▓▓█▓▓▓█▒░▓█▓░░░░░░░░░░░░░░░░░░░░░░░░░░░░░░░░░░░░░
▒▒▒▓▓▓▓▓▓▓▓▓▓▓▓▓▓▓▓▓▓▓▓▓▓▓▓▓▓▓▓▓▓▓▓▓▓▓▒░░░▒▓▓▓▓▓▓▓▓▓▓▓▓▓▓▓▓▓▓▓▓▓▓▓▓▓▓▓▓▓▓▒▓▓▓▓▒░░▒▒▓▓▓▓▓▓▓▓▓▓▓▓▓██████████████████▓▓░░░░░░░░░▒▒▒▓▓▓▓▓▒░░░░░░░░▒▒▒▓▓▓▓▓▓▓▓▓▓█▓▓░░░░░▒▓▓▒▓▓▓█▓▓█▓▓▒█▒░▓█▓░░░░░░░░░░░░░░░░░░░░░░░░░░░░░░░░░░░░░
▒▒▒▒▓▓▓▓▓▓▓▓▓▓▓▓▓▓▓▓▓▓▓▓▓▓▓▓▓▓▓▓▓▓▓▓▓▓▒░░░▒▓▓▓█████████████████████████▓▒▒▒▓▓▓▒░░▒▒▓▓▓▓▓▓▓▓▓▓▓▓▓▓▓▓▓▓▓▓▓█▓█▓██████▓▓░░░░░░▒▒▒▒▒▓▓▓▓▓▓▒░░░░░▒▒▒▒▒▓▓▓▓▓▓▓▓▓▓▓▓▓▓░░░░░▒▓▒▒▒▒▒▓▒▒▓▒▓▒▓▒░▒▓▒░░░░░░░░░░░░░░░░░░░░░░░░░░░░░░░░░░░░░
▒▒▒▒▒▒▓▓▓▓▓▓▓▓▓▓▓▓▓▓▓▓▓▓▓▓▓▓▓▓▓▓▓▓▓▓▓▓▒░░░▒▒▓▓▓▓████████████████████████▓▓▒▓▓▓▒░░▒▒▓▓▓▓▓▓▓▓▓▓▓▓▓▓▓▓▓▓▓▓▓▓▓▓▓▓▓▓▓██▓▓░░░░░░░░░░░░░░░░▒▒░░░░░░░░░░░░░░░░░░░░░░░▓░░░░░░░░░░░░░░░░░░░░░░░▒▒░░░░░░░░░░░░░░░░░░░░░░░░░░░░░░░░░░░░░
▒▒▒▒▒▒▒▓▓▓▓▓▓▓▓▓▓▓▓▓▓▓▓▓▓▓▓▓▓▓▓▓▓▓▓▓▓▒▒░░░▒▒▓▒▒▒▒▒▓▒▓▒▓▓▓▓▓▓▓▓▓▓▓▓▓▓▒▓▓███▓▓▓▓▒░░░▒▓▓▓▓▓▓▓▓▓▓▓▓▓▓▓▓▓▓▓▓▓▓▓▓▓▓▓▓▓▓▓▓▓░░░░░░░░░░░░░░░░▒▒░░░░░░░░░░░░░░░░░░░░░░▒▓░░░░░░░░░░░░░░░░░░░░░░▒▓▒░░░░░░░░░░░░░░░░░░░░░░░░░░░░░░░░░░░░░
▒▒▒▒▒▒▒▒▒▓▓▓▓▓▓▓▓▓▓▓▓▓▓▓▓▓▓▓▓▓▓▓▓▓▓▓▓▒▒░░░▒▒▓▒▒▓██████████████████▓▓▓▓▓███▓▓▓▓▒░░░▒▓▓▓▓▓▓▓▓▓▓▓▓▓▓▓▓▓▓▓▓▓▓▓▓▓▓▓▓▓▓▓▓▓░░░░░░░░░░░░░░░░▒▒░░░░░░░░░░░░░░░▒░░░░░▒▓▓░░░░░░░░░░░░░░░░░░░░░▒▓▓▓░░░░░░░░░░░░░░░░░░░░░░░░░░░░░░░░░░░░░
▒▒▒▒▒▒▒▒▒▒▒▓▓▓▓▓▓▓▓▓▓▓▓▓▓▓▓▓▓▓▓▓▓▓▓▓▓▒▒░░░▒▒▓▒▒▓██████████████████▓▓▓▓▓███▓▓▓▓▒░░░▒▓▓▓▓▓▓▓▓▓▓▓▓▓▓▓▓▓▓▓▓▓▓▓▓▓▓▓▓▓▓▓▓▓░░░░░░░░░▒▒▒▒▒▒▒▒▒░░░░░░░░░▒▒▒▒▒▒▒▒▒▒▒▒▓▓▓░░░░░░░░░░░░░░▒▒▒▒▒▓▒▒▓█▓░░░░░░░░░░░░░░░░░░░░░░░░░░░░░░░░░░░░░
▒▒▒▒▒▒▒▒▒▒▒▒▒▓▓▓▓▓▓▓▓▓▓▓▓▓▓▓▓▓▓▓▓▓▒▓▓▒▒░░░▒▒▓▒▒▓██████████████████▓▒▓▓▓███▓▓▓▓▒░░░▒▓▓▓▓▓▓▓▓▓▓▓▓▓▓▓▓▓▓▓▓▓▓▓▓▓▓▓▓▓▓▓▓▓░░░░░░░░░▒▒▒▒▒▒▒▓▒░░░░░░░░▒▒▒▒▒▒▒▓▓▒▓▒▒▓▓▓░░░░░░░░░░░░░▒▓██▓▒▓▓░▒█▓░░░░░░░░░░░░░░░░░░░░░░░░░░░░░░░░░░░░░
░▒▒▒▒▒▒▒▒▒▒▒▒▒▒▓▓▓▓▓▓▓▓▓▓▓▓▓▓▓▓▓▓▓▒▒▓▒▒░░░▒▒▓▒▒▓██████████████████▓▒▒▓▓███▓▓▓▓▒░░░▒▓▓▓▓▓▓▓▓▓▓▓▓▓▓▓▓▓▓▓▓▓▓▓▓▓▓▓▓▓▓▓▓▓░░░░░░░░░▒▒▒▒▒▓▓▓▒░░░░░░░░▒▒▒▒▒▒▓▓▓▓▓▓▓▓▓▓░░░░░░░░░░░░▒▒▓██▓▒▓▓░▒█▓░░░░░░░░░░░░░░░░░░░░░░░░░░░░░░░░░░░░░
░░▒▒▒▒▒▒▒▒▒▒▒▒▒▒▒▒▓▓▓▓▓▓▓▓▓▓▓▓▓▓▓▓▒▒▓▒▒░░░▒▒▓▒▒▓██████████████████▓▒▒▓▓███▓▓▓▓▒░░░▒▓▓▓▓▓▓▓▓▓▓▓▓▓▓▓▓▓▓▓▓▓▓▓▓▓▓▓▓▓▓▓▓▓░░░░░░░░░▒▒▒▒▒▓▓▓▒░░░░░░░░░▒▒▒▒▓▓▓▓▓▓▓▓▓▓▓░░░░░░░░░░░░▒▒▓██▓▒▓▓░▒█▓░░░░░░░░░░░░░░░░░░░░░░░░░░░░░░░░░░░░░
░░░░▒▒▒▒▒▒▒▒▒▒▒▒▒▒▒▒▓▓▓▓▓▓▓▓▓▓▓▓▓▓▒▒▓▒░░░░▒▒▓▒▒▓██████████████████▓▒▒▓▓███▓▓▓▓▒░░░▒▒▓▓▓▓▓▓▓▓▓▓▓▓▓▓▓▓▓▓▓▓▓▓▓▓▓▓▓▓▓▓▓▓░░░░░▒▒▒▓▓▓▓▓▓▓▓▓▒░░░░▒▒▒▒▓▓▓▓▓▓▓▓█████▓▓▓░░░░░░▒▒▒▒▒▓▓▓▓▓▓▓▒▓▓░▒█▓░░░░░░░░░░░░░░░░░░░░░░░░░░░░░░░░░░░░░
░░░░░▒▒▒▒▒▒▒▒▒▒▒▒▒▒▒▒▒▒▓▓▓▓▓▓▓▓▓▓▓▒▒▓▒░░░░░▒▒▒▒▓██████████████████▓▒▒▓▓██▓▓▓▓▓▒░░░▒▒▓▓▓▓▓▓▓▓▓▓▓▓▓▓▓▓▓▓▓▓▓▓▓▓▓▓▓▓▓▓▓▓░░▒▒▒▒▒▒▒▒▒▒▒▒▒▒▒▒░░░░▒▒▒▒▒▒▒▒▒▒▒▒▒▒▒▒▒░░▓░░░░░░░░░░░░░░░░░░░░░░░▒▒░░░░░░░░░░░░░░░░░░░░░░░░░░░░░░░░░░░░░
░░░░░░░▒▒▒▒▒▒▒▒▒▒▒▒▒▒▒▒▒▒▒▓▓▓▓▓▓▓▓▒▒▓▒░░░░░▒▒▒▒▓██████████████████▓▒▒▓▓██▓▓▓▓▓▒░░░▒▒▓▓▓▓▓▓▓▓▓▓▓▓▓▓▓▓▓▓▓▓▓▓▓▓▓▓▓▓▓▓▓▓░░░░░░░░░░░░░░░░▒▒░░░░░░░░░░░░░░░░░░░░░░▒▓░░░░░░░░░░░░░░░░░░░░░░░▒▒░░░░░░░░░░░░░░░░░░░░░░░░░░░░░░░░░░░░░
░░░░░░░░▒▒▒▒▒▒▒▒▒▒▒▒▒▒▒▒▒▒▒▒▒▒▓▓▓▒▒▒▓▒░░░░░▒▒▒▒▓▓▓▓███████████████▓▒▒▓▓██▓▓▓▓▓▒░░░▒▒▓▓▓▓▓▓▓▓▓▓▓▓▓▓▓▓▓▓▓▓▓▓▓▓▓▓▓▓▓▓▓▓░░░░░░░░░░░░░░░░▒▒░░░░░░░░░░░░░░░░░░░░░▒▓▓░░░░░░░░░░░░░░░░░░░░░▒▒▓▒░░░░░░░░░░░░░░░░░░░░░░░░░░░░░░░░░░░░░
░░░░░░░░░░▒▒▒▒▒▒▒▒▒▒▒▒▒▒▒▒▒▒▒▒▒▒▒▒▒▒▓▒░░░░░▒▒▒▒▓▓▓▓▓▓▓▓▓▓▓▓▓▓▓▓▓▓▓▓▒▒▓▓██▓▓▓▓▓▒░░░▒▒▒▓▓▓▓▓▓▓▓▓▓▓▓▓▓▓▓▓▓▓▓▓▓▓▓▓▓▓▓▓▓▓░░░░░░░░░░░▒▒▒▒▒▒▒░░░░░░░░░░▒▒▒▒▒▒▒▒▒▒▒▓▓▓░░░░░░░░░░▒▒▒░░░░░░░▒▒▓▓▒░░░░░░░░░░░░░░░░░░░░░░░░░░░░░░░░░░░░░
▒▒▒▒▒▒▒▒▒▒▒▒▒▒▒▒▒▒▒▒▒▒▒▒▒▒▒▒▒▒▒▒▒▒▒▒▓▒░░░░░▒▒▒▒▒▓▓▓▓▓▓▓▓▓▓▓▓▓▓▓▓▓▓▓▓▓▓▓██▓▓▓▓▓▒░░░▒▒▒▒▒▓▓▓▓▓▓▓▓▓▓▓▓▓▓▓▓▓▓▓▓▓▓▓▓▓▓▓▓▓░░░░░░░░░▒▒▒▒▒▒▒▒▒░░░░░░░░░▒▒▒▒▒▒▒▒▒▒▒▒▓▓▓░░░░░░░░░▒█▓▒░░▒▓▓▓▓▓▓▓▒▒░░░░░░░░░░░░░░░░░░░░░░░░░░░░░░░░░░░░░
▓▓▓▓▓▓▓▓▓▓▓▓▓▓▓▓▓▓▓▓▓▓▓▓▓▓▓▓▓▓▓▓▓▓▒▒▓▒░░░░░▒▒▒▒▒▒▒▓▓▓▓▓▓▓▓▓▓▓▓▓▓▓▓▓▓▓▓▓▓▓▓▓▓▓▓▒░▒▓▓▓▓▓▓▓▓▓▓▓▓▓▓▓▓▓▓▓▓▓▓▓▓▓▓▓▓▓▓▓▓▓▓▓░░░░░░░░░░▒▒▒▒▒▒▓▒░░░░░░░░░▒▒▒▒▒▒▒▒▒▓▒▒▓▓▓░░░░░░░░░▒█▓▒░░▒█▓▓▓▓▓▓░▒░░░░░░░░░░░░░░░░▒▒▒▒▒▒▒▒▒▒▒▒▒▒▒▒▒░░░░
▒▒▒▒▓▓▓▓▓▓▓▓▓▓▓▓▓▓▓██████████████▓▒▒▓▒░░░░░▒▒▓▓▓▓▓▓▓▓▓▓▓▓▓▓▓▓▓▓▓▓▓▓▓▓▓▓▓▓▓▓▓▓▓▒░▒▓▓████████████████████████████████▓░░░░░░░░░░▒▒▒▒▒▒▓▒░░░░░░░░░░▒▒▒▒▒▒▒▒▓▓▒▓▓▓░░░░░░░░░▒█▓▒░░▒█▓▓▓▓▓▓░▒░░░░░░░░░░░░░░░░▒▒▒▒▒▒▒▒▒▒▒▒▒▒▒▒▒▒░░░
▒▒▒▒▒▒▒▒▓▓▓▓▓▓▓▓▓▓▓▓▓▓▓▓▓▓▓▓▓▓▓▓▓▓▒▒▒▒░░░░░▒▒▓▓▓▓▓▓▓▓▓▓▓▓▓▓▓▓▓▓▓▓▓▓▓▓▓▓▓▓▓▓▓▓▓▒░▒▓▓▓███████████████████████████████▓░░░░░░░░▒▒▒▓▓▓▓▓▓▒░░░░░░░▒▒▒▒▓▓▓▓▓▓▓▓▓▓▓▓▓░░░░░░░░░▒▓▓▒░░▒▓▓▓▓▓▓▓░▒░░░░░░░░░░░░░░░░░▒▒▒▒▒▒▒▒▒▒▒▒▒▒▒░░░░░
░▒▒▒▒▒▒▒▒▒▒▒▒▒▒▒▒▓▓▓▓▓▓▓▓▓▓▓▓▓▓▓▓▓▒▒▒▒░░░░░░▒▒▒▒▒▒▓▓▓▓▓▓▓▓▓▓▓▓▓▓▓▓▓▓▓▓▓▓▓▒▒▒▓▓▒░░▒▓▓▓▓▓▓▓▓▓▓▓▓▓▓▓▓▓▓▓▓▓▓▓▓▓▓▓▓▓▓▓▓▓▓▒▓▓▓▓▓▓▓▓▓▓▓▓▓▓▓▓▓▓▓▓▓▓▓▓▓▓▓▓▓▓▓▓▓▓▓▓▓▓▓▓▓▒▒▓▓▓▓▓▓▓▓▓▓▓▓▓▓▓▓▓▒▒▒▒▒▒░░░░░░░░░░░░░░░░░░░░░░░░░░░░░░░░░░░░░
▒▒▒▒▒▒▒▒▒▓▒▓▓▓▓▓▓▓▓▓▓▓▓▓▓▓▓▓▓▓▓▓▓▓▓▓▓▒▓▓▓▓▓▓█▓▓▓██▓▓██▓▓███▓▓██▓▓███▓▓██▓▓█▓▓▓▓▓█▓▓███▓▓██▓▓███▓████▓▓██▓████▓███▓▓▓░▒▒▒▒▒▒▒▒▒▒▒▒▒▒▒▒▒▒▒▒▒▒▒▒▒▒▒▒▒▒▒▒▒▒▒▒▒▒▒▒▓▒▒▒▒▒▒▒▒▒▒▒▒▒▒▒▒▒▒▒▒▒▒▒▒▒░░░░░░░░░░░░░░░░░▒▒░▒▒▒▒▒▒▒▒▒░░░░░░░░
▒▒▒▒▒▒▓▓▓▓▓▓▓▓▓▓▓▓▓▓▓▓▓▓▓▓▓█▓▓▓██▓▓███▓▓███▓███▓▓███▓▓███▓███▓▓███▓▓███▓████▓████▓████████▓████▓████▓███▓████▓████▓▓▓▓▓▓▓▓▓▓▓▓▓▓▓▓▓▓▓▓▓▓▓▓▓▓▓▓▓▓▓▓▓▓▓▓▓▓▓▓▓▓▓▓▒▓▓▓▓▓▓▓▓▓▓▓▓▓▓▓▓▓▓▓▒▓▒▒▒▒▒▒▒▒▒▒▒▒▒▒▒▒▒▒▒▒▒▒▒▒▒▒▒▒▒▒▒▒▒░▒▒▒░░░
▒▓▓▓▓▓▓▓▓▓▓▓▓▓▓▓▓▓▓▓▓▓▓▓▓▓▓███████▓▓▓███████▓▓███▓▓███▓▓███▓▓████▓████▓████▓████▓████▓█████████▓████▓████▓████▓████▓████▓████▓████▓████▓████▓████▓▓███▓▓███▓▓██▓▓▓██▓▓▓██▓▓▓▓▓▓▓▓▓▓▓▓▓▓▓▓▓▓▓▓▓▓▓▓▓▓▓▓▓▓▓▓▓▒▒▒▒▒▒▒▒▒▒▒▒▒░░░░░
▓▓▓▓▓▓▓▓▓▓▓▓▓▓▓▓▓▓▓▓▓▓▓▓███▓▓██▓▓▓███████▓▓▓███▓▓███▓▓███▓▓████▓▓███▓▓█████████▓█████████▓████▓▓████▓████▓████▓█████▓████▓████▓▓███▓█████▓████▓█████████▓▓███▓▓███▓▓▓██▓▓▓██▓▓▓▓▓▓▓▓▓▓▓▓▓▓▓▓▓▓▓▓▓▓▓▓▓▓▓▓▓▓▓▓▓▒▒▒▒▒▒▒▒░░░░░░░
▓▓▓▓▓▓▓▓▓▓▓▓▓▓▓▓▓▓▓▓███▓▓███▓▓▓███████▓▓▓████▓████▓▓███▓▓████▓▓████▓███████████████▓█████▓████▓█████▓████▓█████▓████▓█████▓████▓▓████▓████▓█████▓████▓▓███▓▓███▓▓▓███▓▓███▓▓▓██▓▓▓▓▓▓▓▓▓▓▓▓▓▓▓▓▓▓▓▓▓▓▓▓▓▓▓▓▓▓▓▒▒▒▒▒▒▒▒░░░░░░
▒▒▒▒▓▓▓▓▓▓▓▓▓▓▓▓▓██▓▓▓▓█▓▓▓▓██▓▓███▓▓▓████▓▓████▓▓████▓█████▓████▓▓██████████▓██████████▓▓████▓▓███▓▓████▓█████▓█████▓█████▓████▓▓████▓████▓▓████▓▓████▓▓███▓▓████▓▓███▓▓▓██▓▓▓▓█▓▓▓▓▓▓▓▓▓▓▓▓▓▓▓▓▓▓▓▓▓▓▓▓▓▓▓▓▒▒▒▒▒▒▒▒▒▒░░░░░
▒▒▓▒▒▒▓▓▓▓▓▓▓▓▓▓▓▓▓▓▓▓▓▓▓█▓▓▓███▓▓▓████▓▓█████▓▓████▓█████▓▓████▓████▓▓█████▓█████▓█████▓█████▓▓███▓▓▓███▓▓████▓█████▓▓█████▓████▓▓███▓▓█████▓▓████▓▓███▓▓▓███▓▓▓███▓▓▓███▓▓▓▓▓▓▓▓▓▓▓▓▓▓▓▓▓▓▓▓▓▓▓▓▓▓▓▓▓▓▒▒▒▒▒▒▒▒▒▒▒▒▒▒░░░░░░
▒▒▓▓▓▓▓▓▓▓▓▓▓▓▓▓▓▓▓▓▓▓▓▓▓▓▓██▓▓▓▓████▓▓████▓▓▓████▒▓████▓▓████▓▓█████▓█████▓█████▓▓████▓▓████▓▓████▓▓▓████▓█████▓█████▓▓████▓▓████▓▓████▓▓████▓▓████▓▓▓█▓█▓▓▓███▓▓▓▓▓▓▓▓▓▓▓▓▓▓▓▓▓▓▓▓▓▓▓▓▓▓▓▓▓▓▓▓▓▓▓▓▓▓▓▓▓▓▒▒▒▒▒▒▒▒▒▒░░░░▒░░░
▒▒▒▒▒▓▓▓▒▒▓▓▓▓▓▒▓▓▓▓▓▓▓▓▓▓▓▓▓▓▓▓▓▓▓▓▓██▓▓▓▓▓▓▓▓▓▓▓████▓▒▓█▓█▓▓▓█▓▓█▓▓████▓▓▓████▓▓████▓▓▓████▓▓████▓▓▓▓▓▓▓▓█████▓▓▓███▓▓█▓▓▓▓▓▓███▓▓▓▓▓▓▓▓▓████▓▓▓██▓▓▓▓▓▓▓▓▓▓▓▓▓▓▓▒▓▓▓▓▓▒▓▓▓▓▓▒▓▓▓▓▓▓▓▓▓▓▓▓▒▒▓▓▓▒▒▒▒▒▒▒▒▒▒▒▒▒▒▒░░░░░░░░░░░░
▒▒▒▒▒▒▒▒▒▒▒▒▒▒▓▓▓▒▒▓▓▓▓▓▒▒▓▓▓▓▓▓▓▓▓▓▓▓▓▓▓▓▓▓▓▓▒▓▓▓▓▓▓▒▓▓▓▓▓▓▒▓▓▓▓▓▓▓▓███▓▓▓▓▓▓▓▓▓▓████▓▓▓▓▓▓▓▓▓▓▓▓█▓▓▓▓▓▓▓▒▓▓█▓▓▓▓▓▓▓▓▓▓▓▓▓▓▓▓▓▓▓▓▓▓▓▓▓▓▓▓▓▓▓▓▓▓▓▓▓▓▓▓▓▓▓▓▓▓▓▓▓▒▓▓▓▓▓▒▒▓▒▓▒▒▒▓▓▓▓▒▒▓▓▓▓▓▒▒▓▓▓▒▒▒▒▒▒▒▒▒▒▒▒▒▒▒▒▒▒▒▒░░░░░░░░░░░
░░░▒▒▒▒▒▒▒▒▒▒▒▒▒▒▒▓▓▓▒▒▒▓▓▓▓▓▒▒▓▓▓▓▓▓▒▒▒▒▓▓▒▒▓▓▓▓▓▓▒▒▓▓▓▓▓▒▒▓▓▓▓▓▒▓▓▓▓▓▓▒▓▓▓▓▓▓▓▓▓▓▓▓▓▓▓▓▓▓▓▓▓▓▓▓▓▓▒▒▓▓▓▓▓▒▓▓▓▓▓▓▒▓▓▓▓▓▓▒▓▓▓▓▓▓▒▓▓▓▓▓▒▒▓▓▓▓▓▒▓▓▓▓▓▓▒▓▓▓▓▓▓▒▓▓▓▒▒▒▒▒▓▓▒▒▒▒▒▒▒▒▒▒▒▒▒▒▒▒▒▒▒▒▒▒▒▒▒▒▒▒▒▒▒▒▒▒▒▒▒▒▒░░░░░░░░░░░░░░░░
░░░░░░░░░░▒▒▒▒▒▒▒▒▒▒▒▒▒▒▒▒▒▒▒▒▒▒▒▒▒▒▒▒▒▒▒▒▒▒▒▒▒▒▒▒▒▒▒▒▒▒▒▒▒▒▓▓▓▒▒▒▓▓▓▓▓▒▒▓▓▓▓▒▒▒▓▓▓▓▓▒▒▒▒▒▒▒▒▒▒▓▒▒▒▒▒▓▒▒▒▒▒▒▒▓▓▓▓▒▒▒▒▓▒▒▒▒▒▒▒▒▒▒▒▓▓▓▓▒▒▒▒▒▒▒▒▒▒▓▓▒▒▒▒▒▒▒▒▒▒▒▒▒▒▒▒▒▒▒▒▒▒▒▒▒▒▒▒░▒▒▒▒▒▒▒▒░▒▒▒▒▒▒▒▒▒▒▒░░░░░░░░░░░░░░░░░░░░░░░░░░
