▓▓▒▒▒▒▓▓███████▓▓▓▒▓▓▓▓▓▒▒▒▒░▒░░░░░░░▒▒▒▒▒▒▒▓▓▓▓▓▓▓▓▓▓▓▓▓▓▓▓▓▓▓▓▓▓▓▓▓▓▓▓▓▓▓▓▓▓▓▓▓▓▓▓▓▓▓▓▓▓▓▓▓▓▓▓▓▓▓▓▓▓▓▓▓▓▓▓▓▓▓▓▓▓▓▓▓▓▓▓▓▓▓▓▓▒▒▒▒▒▒▒▒▒▒▒▒▒▒▒▒▒▒▒▒▒▒▒▒▒▒▒▒▒▒▒▒▒▒▒▒▒▒▒▒▒▒▒▒▒▒▒▒▒▒▒▒▒▒▒▒▒▒▒▒▒▒▒▒▒▒▒▒▒▒▒▒▒▒▒▒▒▒▒▒▒▒▒▒▒▒▒▒▒▒▒▒▒▒▒
███▓▒▒▒▒▒▓▓██████▓▓▓██▓▓▓▒▒▒▒░░░░░░░░░░░░▒▒▒▒▒▒▒▒▓▓▓▓▓▓▓▓▓▓▓▓▓▓▓▓▓▓▓▓▓▓▓▓▓▓▓▒▒▒▓▓▒▒▒▒▓▓▓▒▒▒▒▒▒▒▒▒▒▒▒▒▒▒▒▒▒▒▒▒▒▒▒▒▒▒▒▒▒▒▒▒▒▒▒▒▒▒▒▒▒▒▒▒▒▒▒▒▒▒▒▒▒▒▒▒▒▒▒▒▒▒▒▒▒▒▒▒▒▒▒▒▒▒▒▒▒▒▒▒▒▒▒▒▒▒▒▒▒▒▒▒▒▒▒▒▒░▒░▒▒░░░░░░░░░░░░░░░░░░░░░░░░░░░░░
██████▓▒▒▒▒▒▓▓▓████████▓▓▓▒▒▒▒░░░░░░░░░░░▒▒▒▒▒▒▒▒▒▓▓▓▓▓▓▓▓▓▓▓▓▓▓▓▓▓▓▓▓▓▓▓▓▓▓▒▒▒▒▒▒▒▒▒▒▒▒▒▒▒▒▒▒▒▒▒▒▒▒▒▒▒▒▒▒▒▒▒▒▒▒▒▒▒▒▒▒▒▒▒▒▒▒▒▒▒▒▒▒▒▒▒▒▒▒▒▒▒▒▒▒▒▒▒▒▒▒▒▒▒▒▒▒▒▒▒▒▒▒▒▒▒▒▒▒▒▒▒▒▒▒▒▒▒▒▒▒▒▒░▒▒▒░░░░░░░░░░░░░░░░░░░░░░░░░░░░░░░░░░░░
████████▓▓▒▒▒▒▒▓▓▓▓█████▓▓▒▒▒▒▒░░░░░░░░░▒▒▒▒▒▒▒▒▒▓▓▓▓▓▓▓▓▓▓▓▓▓▓▓▓▓▓▓▓▓▓▓▓▓▓▓▓▓▓▓▓▓▓▓▓▓▓▓▓▓▓▒▒▒▒▒▒▒▒▒▒▒▒▒▒▒▒▒▒▒▒▒▒▒▒▒▒▒▒▒▒▒▒▒▒▒▒▒▒▒▒▒▒▒▒▒▒▒▒▒▒▒▒▒▒▒▒▒▒▒▒▒▒▒▒▒▒▒▒▒▒▒▒▒▒▒▒▒▒▒▒▒▒▒▒▒▒▒▒▒▒▒▒▒▒▒▒▒▒▒▒▒░░▒░░▒░░░░░░░░░░░░░░░░░░░░░░
███████████▓▒▒▒▒▒▒▓██████▓▒▒▒▒▒░░░░░░░░░▒▒▒▒▒▒▒▒▓▓▓▓▓▓▓▓▓▓▓▓▓▓▓▓▓▓▓▓▓▓▓▓▓▓▓▓▓▓▓▓▓▓▓▓▓▓▓▓▓▓▓▓▓▓▓▓▓▓▓▓▓▓▓▒▒▓▒▒▒▒▒▒▒▒▒▒▒▒▒▒▒▒▒▒▒▒▒▒▒▒▒▒▒▒▒▒▒▒▒▒▒▒▒▒▒▒▒▒▒▒▒▒▒▒▒▒▒▒▒▒▒▒▒▒▒▒▒▒▒▒▒▒▒▒▒▒▒▒▒▒▒▒▒▒▒▒▒▒▒▒▒▒▒▒▒▒▒▒▒▒▒▒▒░░░░░░░░░░░░░░░░░
██▓█████████▓▒▒▒▒▒▓██████▓▒▒▒▒▒▒░░░░▒▒▒▒▒▒▒▒▒▒▒▒▓▓▓▓▓▓███████████████▓██▓▓▓▓▓▓▓█▓▓▓▓▓▓▓▓▓▓▓▓▓▓▓▓▓▓▓▓▓▓▓▓▓▓▓▓▓▓▓▓▓▓▓▓▓▓▓▓▓▓▓▓▓▓▓▓▓▓▓▓▓▓▓▓▓▓▓▓▒▒▒▒▒▒▒▒▒▒▒▒▒▒▒▒▒▒▒▒▒▒▒▒▒▒▒▒▒▒▒▒▒▒▒▒▒▒▒▒▒▒▒▒▒▒▒▒▒▒▒▒▒▒▒▒▒▒▒▒▒▒▒▒▒▒▒▒▒▒▒▒▒▒▒▒▒▒▒▒
█████████████▒▒▒▒▓▓███████▓▒▒▒▒▒▒░░▒▒▒▒▒▒▒▒▒▒▒▒▓▓▓██████████████████████████████████████▓▓█▓▓▓▓▓▓▓▓▓▓▓▓▓▓▓▓▓▓▓▓▓▓▓▓▓▓▓▓▓▓▓▓▓▓▓▓▓▓▓▓▓▓▓▓▓▓▓▓▓▓▓▓▓▓▓▓▓▒▒▒▒▒▒▒▒▒▒▒▒▒▒▒▒▒▒▒▒▒▒▒▒▒▒▒▒▒▒▒▒▒▒▒▒▒▒▒▒▒▒▒▒▒▒▒▒▒▒▒▒▒▒▒▒▒▒▒▒▒▒▒▒▒▒▒▒▒▒▒▒
█████████████▒▒▒▓▓████████▓▒▒▒▒▒▒░░▒▒▒▒▒▒▒▒▒▒▒▒▒▓▓▓▓▓▓▓▓▓▓▓▓▓▓▓▓▓▓▓▓▓▓▓▓▓▓▓▓▓▓▓██▓▓▓██▓▓▓▓▓▓▓▓▓▓▓▓▓▓▓▓▓▓▓▓▓▓▓▓▓▓▓▓▓▒▓▓▓▓▓▒▒▒▒▒▒▒▒▒▒▒▒▒▒▒▒▒▒▒▒▒▒▒▒▒▓▒▒▒▒▒▒▒▒▒▒▒▒▒▒▒▒▒▒▒▒▒▒▒▒▒▒▒▒▒▒▒▒▒▒▒▒▒▒▒▒▒▒▒▒▒▒▒▒▒▒▒▒▒▒▒▒▒▒▒▒▒▒▒▒▒▒▒▒▒▒▒▒░
████████████▓▒▒▒▓▓████████▓▒▒▒▒▒▒░░▒▒▒▒▒▒▒▒▒▒▓▓▓▓▓██████████████████████████▓▓▓██▓▓▓██▓▒▓▓█████▓██▓▓▓▓▓▓▓▓▓▓▓▓▓▓▓▓▓▓▓▓▓▓▓▓▓▓▓▓▓▓▓▓▓▓▓▓▓▓▓▓▓▓▓▓▓▒▒▒▓▒▒▒▒▒▒▒▒▒▒▒▒▒▒▒▒▒▒▒▒▒▒▒▒▒▒▒▒▒▒▒▒▒▒▒▒▒▒▒▒▒▒▒▒▒▒▒▒▒▒▒▒▒▒▒▒▒▒▒▒▒▒▒▒▒▒▒▒▒▒▒▒░
████████████▓▒▒▓▓█████████▓▒▒▒▒▒▒░░▒▒▒▒▒▒▒▒▒▓▓▓▓▓███████████████████████████▓▓▓███▓▓██▓▓▓████████████▓█▓▓▓▓▓▓▓▓▓▓▓▓▓▓▓▓▓▓▓▓▓▓▓▓▓▓▓▓▓▓▓▓▓▓▓▓▓▓▓▓▒▒▒▓▒▒▒▒▒▒▒▒▒▓▓▓▓▓▒▒▓▒▒▒▒▒▒▒▒▒▒▒▒▒▒▒▒▒▒▒▒▒▒▒▒▒▒▒▒▒▒▒▒▒▒▒▒▒▒▒▒▒▒▒▒▒▒▒▒▒▒▒▒▒▒▒░
█████████████▒▒▓▓█████████▓▒▒▒▒▒▒░░▒▒▒▒▒▒▒▒▓▓▓▓▓▓███████████████████████████▓▓▓███▓▓██▓▓▓████████████████▓▓▓▓▓▓▓▓▓▓▓▓▓▓▓▓▓▓▓▓▓▓▓▓▓▓▓▓▓▓▓▓▓▓▓▓▓▓▒▒▒▓▒▒▒▒▒▒▒▒▒▓▓▓▓▓▓▓▓▓▒▒▓▒▒▒▒▒▒▒▒▒▒▒▒▒▒▒▒▒▒▒▒▒▒▒▒▒▒▒▒▒▒▒▒▒▒▒▒▒▒▒▒▒▒▒▒▒▒▒▒▒▒▒░
█████████████▒▒▓██████████▓▒▒▒▒▒▒▒░▒▒▒▒▒▒▒▓▓▓▓▓▓████████████████████████████▓▓▓███▓▓██▓▓▓████████████▓▓▓▓▓▓▓▓▓▓▓▓▓▓▓▓▓▓▓▓▓▓▓▓▓▓▓▓▓▓▓▓▓▓▓▓▓▓▓▓▓▓▒▒▓▓▒▒▒▒▒▒▒▒▒▓▓▓▓▓▒▓▒▒▒▒▒▒▒▒▒▒▒▒▒▒▒▒▒▒▒▒▒▒▒▒▒▒▒▒▒▒▒▒▒▒▒▒▒▒▒▒▒▒▒▒▒▒▒▒▒▒▒▒▒▒▒▒░
█████████████▒▒▓██████████▓▒▒▒▒▒▒▒░▒▒▒▒▒▒▒▓▓▓▓▓▓████████████████████████████▓▓▓███▓▓██▓▓▓██████████▓▓▓▓▓▓▓▓▓▓▓▓▓▓▓▓▓▓▓▓▓▓▓▓▓▓▓▓▓▓▓▓▓▓▓▓▓▓▓▓▓▓▓▓▒▒▒▓▒▒▒▒▒▒▒▒▒▓▓▓▒▒▒▒▒▒▒▒▒▒▒▒▒▒▒▒▒▒▒▒▒▒▒▒▒▒▒▒▒▒▒▒▒▒▒▒▒▒▒▒▒▒▒▒▒▒▒▒▒▒▒▒▒▒▒▒▒▒▒▒░
█████████████▓▒▓██████████▓▒▒▒▒▒▒▒░▒▒▒▒▒▒▒▓▓▓▓▓▓████████████████████████████▓▓▓███▓▓██▓▒▓▓▓▓▓▓▓▓▓▓▓▓▓▓▓▓▓▓▓▓▓▓▓▓▓▓▓▓▓▓▓▓▒▒▒▒▒▒▒▒▒▒▒▒▒▒▒▒▒▒▒▒▒▒▒▒▒▒▒▒▒▒▒▒▒▒▒▒▓▒▒▒▒▒▒▒▒▒▒▒▒▒▒▒▒▒▒▒▒▒▒▒▒▒▒▒▒▒▒▒▒▒▒▒▒▒▒▒▒▒▒▒▒▒▒▒▒▒▒▒▒▒▒▒▒▒▒▒▒▒▒▒
█▓███████████▒▒▓██████████▓▒▒▒▒▒▒▒░▒▒▒▒▒▒▓▓▓▓▓▓▓████████████████████████████▓▓▓███▓▓█▓▒▒▓▓▓▒▒▒▒▒▒▒▒▒▒▒▒▒▒▒▒▒▒▒▒▒▒▒▒▒▒▒▒▒▒▒▒▒▒▒▒▒▒▒▒▒▒▒▒▒▒▒▒▒▒▒▒▒▒▒▒▒▒▒▒▒▒▒▒▒▓▒▒▓▓▓▓▓▓▓▓▓▓▓▓▓▓▒▒▓▒▒▒▒▒▒▒▒▒▒▒▒▒▒▒▒▒▒▒▒▒▒▒▒▒▒▒░░░░▒▒▒▒▒▒▒▒▒▒▒▒░
██████▓██████▓▒▓██████████▓▒▒▒▒▒▒▒░▒▒▒▒▒▒▓▓▓▓▓▓▓████████████████████████████▓▓▓███▓▓█▓▒▒▒▓▓▓▓▒▒▒▒▒▒▒▒▒▒▒▒▒▒▒▒▒▒▒▒▒▒▒▒▒▒▒▒▒▒▒▒▒▒▒▒▒▒▒▒▒▒▒▒▒▒▒▒▒▒▒▒▒▒▒▒▒▒▒▒▒▒▒▓▒▒▓▓▓▓▓▓▓▓▓▓▓▓▓▓▓▓▓▓▓▓▓▓▓▓▒▓▓▒▒▒▒▒▒▒▒▒▒▒▒▒▒▒▒▒░░░░▒▒▒▒▒▒▒▒▒▒▒▒▒
█████████████▓▒▓██████████▓▒▒▒▒▒▒▒░▒▒▒▒▒▒▓▓▓▓▓▓▓████████████████████████████▓▓▓███▓▓█▓▒▒▒▒░░▒▒▒▒▒▒▒▒▒▒▒▒▒▒▒▒▒▒▒▒▒▒▒▒▒▒▒▒▒▒▒▒▒▒░▒░░░░░░░░░░░░░░░▒▒▒▒▒▒▒▒▒▒▒▒▒▓▒▒▓▓▓▓▓▓▓▓▓▓▓▓▓▓▓▓▓▓▓▓▓▓▓▓▓▓▓▓▒▒▒▒▒▒▒▒▒▒▒▒▒▒▒▒░░░░▒▒▒▒▒▒▒▒▒▒▒▒▒
████████████▓▒▒▓██████████▓▒▒▒▒▒▒▒░▒▒▒▒▒▒▓▒▓██████████████████████████▓▒▒▓▓▓▓▓▓███▓▓█▓▒▒▒▒░░░▒▒▒▒▒▒▒▒▒▒▒▒▒▒▒▒▒▒▒▒▒▒▒▒▒▒▒▒▒▒▒▒▒▒▒▒▒▒▒▒▒▒▒▒▒▒▒▒▒▒▒▒▒▒▒▒▒▒▒▒▒▒▒▓▒▒▓▓▓▓▓▓▓▓▓▓▓▓▓▓▓▓▓▓▓▓▓▓▓▓▓▓▓▓▓▒▒▒▒▒▒▒▒▒▒▒▒▒▒▒░░░░▒▒▒▒▒▒▒▒▒▒▒▒▒
█████████████▓▒▓██████████▓▒▒▒▒▒▒▒░▒▒▒▒▒▒▓▒▓███████████████████████████▒▒▓▓▓▓▓▓███▓▓█▓▒▒▒▒░░░▒▒▒▒▒▒▒▒▒▒▒▒▒▒▒▒▒▒▒▒▒▒▒▒▒▒▒▒▒▒▒▒▒▒▒▒▒▒▒▒▒▒▒▒▒▒▒▒▒▒▒▒▒▒▒▒▒▒▒▒▒▒▓▓▒▒▓▓▓▓▓▓▓▓▓▓▓▓▓▓▓▓▓▓▓▓▓▓▓▓▓▓▓▓▒▒▒▒▒▒▒▒▒▒▒▒▒▒▒▒░░░░▒▒▒▒▒▒▒▒▒▒▒▒▒
█████████████▓▒▓██████████▓▒▒▒▒▒▒▒░▒▒▒▒▒▒▓▒▓███████████████████████████▒▒▓▓▓▓▓▓███▓▓█▓▒▒▓▒░░░▒▒▒▒▒▒▒▒▒▒▒▒▒▒▒▒▒▒▒▒▒▒▒▒▒▒▒▒▒▒▒▒▒▒▒▒▒▒▒▒▒▒▒▒▒▒▒░▒▒▒▒▒▒▒▒▒▒▒▒▒▒▓▓▒▒▓▓▓▓▓▒▒▓▓▓▓▓▓▓▓▓▓▓▓▓▓▓▓▓▓▓▒▒▒▒▒▒▒▒▒▒▒▒▒▒▒▒▒▒░░░░▒▒▒▒▒▒▒▒▒▒▒▒░
█████████████▓▒▓██████████▓▒▒▒▒▒▒▒░▒▒▒▒▒▒▒▒▓███████████████████████████▒▒▓▓▓▓▓▓███▓▓█▓▒▒▓▒░░░▒▒▒▒▒▒▒▒▒▒▒▒▒▒▒▒▒▒▒▓▒▒▒▒▒▒▒▒▒▒▒▒▒▒▒▒▒▒▒▒▒▒▒▒▒▒▒░░▒▒▒▒▒▒▒▒▒▒▒▒▒▓▓▒▒▓▓▓▓▒▒▒▒▒▓▓▓▓▓▓▓▓▓▓▓▓▓▓▓▓▒▒▒▒▒▒▒▒▒▒▒▒▒▒▒▒▒▒▒░░░░▒▒▒▒▒▒▒▒▒▒▒▒▒
█████████████▓▒▓██████████▓▒▒▒▒▒▒▒░▒▒▒▒▒▒▓▒▓███████████████████████████▒▒▓▓▓▓█████▓▓█▓▒▒▓▒░░░▒▒▒▒▒▒▒▒▒▒▒▒▒▒▒▒▒▒▒▒▒▒▒▒▒▒▒▒▒▒▒░▒▒▒▒▒▒▒▒▒▒▒▒▒▒▒░░▒▒▒▒▒▒▒▒▒▒▒▒▒▓▓▒▒▓▓▓▓▒▒▒▒▒▒▓▓▓▓▓▓▓▒▒▓▓▓▓▓▓▒▒▒▒▒▒▒▒▒▒▒▒▒▒▒▒▒▒▒░░░░▒▒▒▒▒▒▒▒▒▒▒▒▒
█████████████▓▒▓███████████▒▒▒▒▒▒▒░▒▒▒▒▒▒▒▒▓███████████████████████████▒▒▓▓▓██████▓██▓▒▓▓▒░░░▒▒▒▒▒▒▒▒▒▒▒▒▒▒▒▒▒▒▒▓▒▒▒▒▒▒▒▒▒▒▒░▒▒▒▒▒▒▒▒▒▒▒▒▒▒▒░▒▒▒▒▒▒▒▒▒▒▒▒▒▒▓▓▒▒▓▓▓▒▒▒▒▒▒▒▒▓▓▓▓▓▒▒▒▒▓▓▓▓▓▒▒▒▒▒▒▒▒▒▒▒▒▒▒▒▒▒▒▒░░░░▒▒▒▒▒▒▒▒▒▒▒▒▒
█████████████▓▒▓███████████▒▒▒▒▒▒▒░▒▒▒▒▒▒▒▒▓▓██████████████████████████▒▒▓▓▓██████████▓▓▓▒░░░▒▒▒▒▒▒▒▒▒▒▒▒▒▒▒▒▒▒░▓▒▒▒▒▒▒▒▒▒▒▒░▒▒▒▒▒▒▒▒▒▒▒▒▒▒▒░░▒▒▒▒▒▒▒▒▒▒▒▒▒▓▓▒▒▓▓▒▒▒▒▒▒▒▒▒▓▓▓▓▒▒▒▒▒▒▒▓▒▒▒▒▒▒▒▒▒▒▒▒▒▒▒▒▒▒▒▒▒░░░░▒▒▒▒▒▒▒▒▒▒▒▒▒
█████████████▓▒▓██████████▓▒▒▒▒▒▒▒░▒▒▒▒▒▒▒▒▓▓▓▓▓▓██████████████████████▒▒▓▓▓██████████▓▓▓▒░░░▒▒▒▒▒▒▒▒▒▒▒▒▒▒▒▒▒▒▒▓▒▒▒▒▒▒▒▒▒▒▒▒▒▒▒▒▒▒▒▒▒▒▒▒▒▒▒░▒▒▒▒▒▒▒▒▒▒▒▒▒▒▓▓▒▒▓▓▒▒▒▒▒▒▒▒▒▒▒▓▒▒▒▒▒▒▒▒▒▒▒▒▒▒▒▒▒▒▒▒▒▒▒▒▒▒▒▒▒▒░░░░▒▒▒▒▒▒▒▒▒▒▒▒▒
█████████████▓▒▓███████████▒▒▒▒▒▒▒░▒▒▒▒▒▒▒▒▒▒▓▓▓▓█████████████████████▓▒▒▓▓▓██████████▓▓█▒░░▒▒▒▓▒▒▓▓▓▓▒▒▒▒▒▒▒▒▒▒▓▒▒▒▒▒▒▒▒▒▒▒▒▒▒▒▒▒▒▒▒▒▒▒▒▒▒▒░▒▒▒▒▒▒▒▒▒▒▒▒▒▒▓▓▒▒▒▒▒▒▒▒▒▒▒▒▒▒▒▒▒▒▒▒▒▒▒▒▒▒▒▒▒▒▒▒░░░░░▒▒▒▒▒▒▒▒▒░░░░▒▒▒▒▒▒▒▒▒▒▒▒▒
████████████▓▓▒▓██████████▓▒▒▒▒▒▒▒░▒▒▒▒▒▒▒▒▒▒▒▒▒▓▓███████████████████▓▓▒▒▓▓▓██████████▓▓█▒░░▒▒▒▓▒▒▓██▓▓▓▓▓▒▒▒▒▒▒▓▒▒▒▒▒▒▒▒▒▒▒░▒▒▒▒▒▒▒▒▒▒▒▒▒▒▒░▒▒▒▒▒▒▒▒▒▒▒▒▒▒▓▓▒▒▒▒▒▒▒▒▒▒▒▒▒▒▒▒▒▒▒▒▒▒▒▒▒▒▒▒▒▒▒░░░░░░░▒▒▒▒▒▒▒▒░░░░▒▒▒▒▒▒▒▒▒▒▒▒▒
█████████████▓▒▓███████████▒▒▒▒▒▒▒░▒▒▒▒▒▒▒▒▒▒▒▒▒▒▓▓████████████████▓▓▓▓▒▒▓▓▓██████████▓▓█▒░░▒▒▒▓▒▒▓████▓▓▓▓▓▓▒▒░▓▒▒▒▒▒▒▒▒▒▒▒▒▒▒▒▒▒▒▒▒▒▒▒▒▒▒▒░▒▒▒▒▒▒▒▒▒▒▒▒▒▒▓▓▒▒▒▒▒▒▒░░░░░░▒▒▒▒▒▒░░░▒▒▒▒▒▒▒░░░░░░░░░░▒▒▒▒▒▒▒░░░░▒▒▒▒▒▒▒▒▒▒▒▒▒
█████████████▓▒▓██████████▓▒▒▒▒▒▒▒░▒▒▒▒▒▒▒▒▒▒▒▒▒▒▓▓▓███████████▓▓▓▓▓▓▓▓▒▒▓▓▓██████████▓▓█▒░░▒▒▒▓▒▒███████▓▓▓▓▒▒▒▓▒▒▒▒▒▒▒▒▒▒▒▒▒▒▒▒▒▒▒▒▒▒▒▒▒▒▒░▒▒▒▒▒▒▒▒▒▒▒▒▒▒▓▓▒▒▒▒▒▒▒░░░░░░░░▒▒▒▒░░░░▒▒▒▒▒░░░░░░░░░░░░▒▒▒▒▒▒░░░░▒▒▒▒▒▒▒▒▒▒▒▒▒
█████████████▓▒▓██████████▓▒▒▒▒▒▒▒░▒▒▒▒▒▒▒▒▒▒▒▒▒▒▒▓▓▓███████▓▓▓▓▓▓▓▓▓▓▓▒▒▓▓▓██████████▓▓█▒░░▒▒▒▓▒▒█████████▓▓▓▒▒▓▒▒▒▒▒▒▒▒▒▒▒▒▒▒▒▒▒▒▒▒▒▒▒▒▒▒▒░▒▒▒▒▒▒▒▒▒▒▒▒▒▒▓▓▒▒▒▒░░░░░░░░░░░░░░░░░░░░░░░░░░░░░░░▒░░▒▒▒▒▒▒▒▒░░░░▒▒▒▒▒▒▒▒▒▒▒▒▒
█████████████▓▓▓██████████▓▒▒▒▒▒▒▒░▒▒▒▒▒▒▒▒▒▒▒▒▒▒▒▓▓▓██████▓▓▓▓▓▓▓▓▓▒▒▒▒▒▓▓▓██████████▓▓█▒░░▒▓▒▓▒▒███████████▓▓▒▓▒▒▒▒▒▒▒▒▒▒▒▒▒▒▒▒▒▒▒▒▒▒▒▒▒▒▒░▒▒▒▒▒▒▒▒▒▒▒▒▒▒▓▓▒▒░░░░░░░░░░░░░░░░░░░░░░░░░░░░░▒▒▒▒▒▒▒▒▒▒▒▒▒▒▒░░░░▒▒▒▒▒▒▒▒▒▒▒▒▒
█████████████▓▓▓██████████▓▒▒▒▒▒▒▒░▒▒▒▒▒▒▒▒░░░▒▒▒▒▒▒▓▓████▓▓▓▓▓▓▓▓▓▓▒▒▓▒▒▓▓▓██████████▓▓█▒░░▒▓▒▓▒▓███████████▓▓▒▓▒▒▓▓▒▓▒▒▒▒▒▒▒▒▒▒▒▒▒▒▒▒▒▒▒▒▒░▒▒▒▒▒▒▒▒▒▒▒▒▒▒▓▓▒░░░░░░░░░░░░░░░░░░░░░░░▒░▒▒▒▒▒▒▒▒▒▒▒▒▒▒▒▒▒▒▒▒░░░░▒▒▒▒▒▒▒▒▒▒▒▒▒
█████████████▓▓▓██████████▓▒▒▒▒▒▒▒░▒▒▒▒▒▒▒▒░░░▒▒▒▒▒▒▓▓██████▓▓▓██▓█▓▓▓▓▓▒▓▓▓██████████▓▓█▒░░▒▓▒▓▒▓███████████▓▓▒█▒▒▓▓▓▓▓▓▒▒▒▒▒▓▒▒▒▒▒▒▒▒▒▒▒▒▒▒▒▒▒▒▒▒▒▒▒▒▒▒▒▒▓▓▒▒▒▒░░▒▒▒▒▒▒▒▒▒▒▒▒▒▒▒▒▒▒▒▒▒▒▒▒▒▒▒▒▒▒▒▒▒▒▒▒▒▒▒▒░░░░▒▒▒▒▒▒▒▒▒▒▒▒▒
▓████████████▓▓▓██████████▓▒▒▒▒▒▒▒░▒▒▒▒▒▒▒▒░░░▒▒▒▒▓▓███████████████▓▓▓▓▒▒▓▓▓██████████▓▓█▒░░▒▓▒▓▒▓████████████▓▒█▒▒█▓▓▓▓▓▒▒▒▒▒▓▓▒▒▒▒▒▒▒▒▒▒▒▒▒▒▒▒▒▒▓▓▒▒▒▒▓▓▒▓▓▒▒▒▒▒▒▒▒▒▒▒▒▒▒▒▒▒▒▒▒▒▒▒▒▒▒▒▒▒▒▒▒▒▒▒▒▒▒▒▒▒▒▒▒▒▒░░░░▒▒▒▒▒▒▒▒▒▒▒▒▒
▓████████████▓▓▓██████████▓▒▒▒▒▒▒▒░▒▒▒▒▒▒▒▒░░▒▒▒▒▓▓███████████████▓▓▓▓▓▒▒▓▓▓██████████▓▓█▒░░▒▓▒▓▒▓████████████▓▒█▒▓██▓██▓▓▒▒▒▓█▓▓▓▓▓▒▒▒▒▒▒▒▒▒▒▒▓▓▒▓▓▒▒▒▒▓▓▓██▒▒▒▒▒▒▒▒▒▒▒▒▒▒▒▒▒▒▒▒▒▒▒▒▒▒▒▒▒▒▒▒▒▒▒▒▒▒▒▒▒▒▒▒▒▒░░░░▒▒▒▒▒▒▒▒▒▒▒▒▒
▓▓▓▓██▓██████▓▒▓██████████▓▒▒▒▒▒▒▒░▒▒▒▒▒▒▒▒▒▒▒▒▒▓▓▓██████████▓▓▓▓▓▓▓▓▓▓▓▒▓▓▓██████████▓▓█▒░░▒▓▓▓▒▓████████████▓▒█▒▓██▓███▓▒▓▒▓██▓▓▓▓▓▓▓▒▒▒▒▒▒▒▒▓▓▒▓▓▒▒▒▓▓▓▓██▓▒▒▒▒▒▒▒▒▒▒▒▒▒▒▒▒▒▒▒▒▒▒▒▒▒▒▒▒▒▒▒▒▒▒▒▒▒▒▒▒▒▒▒▒▒░░░▒▒▒▒▒▒▒▒▒▒▒▒▒▒
▓▓████▓█████▓▓▒▓██████████▓▒▒▒▒▒▒▒░▒▒▒▒▒▒▒▒▒▒▒▒▓▓█████████████████████████████████████▓▓█▒░░▒▓▒▓▒▒██████▓█████▓▒█▒▓██▓███▓▒▓▒▓██▓▓▓▓▓▓▓▓▓▒▒▒▒▒▓▓▓▒▓▓▒▒▒▓▓▓▓█████▓▓▓▓▓▓▓▓▓▓▓▓▓▒▒▒▒▒▒▒▒▒▒▒▒▒▒▒▒▒▒▒▒▒▒▒▒▒▒▒▒▒▒▒▒▒▒▒▒▒▒▒▒▒▒▒▒▒▒▒
▓█████▓██████▓▒▓██████████▓▒▒▒▒▒▒▒░░▒▒▒▒▒▒▒▒▒▒▒▓▓█████████████████████████████████████▓▓█▒░░▒▓▒▓▒▓██████▓██▓██▓▒█▒▓██▓███▓▒▓▒▓█▓▓▓▓▓▓▓▓▓▓▒▒▓▒▒▓▓▓▒▓▓▒▒▒▓▓▓██████████████▓▓▓▓▓▓▓▓▓▓▓▓▓▓▒▒▒▒▒▒▒▒▒▒▒▒▒▒▒▒▒▒▒▒▒▒▒▒▒▒▒▒▒▒▒▒▒▒▒▒▒▒
▓▓▓███▓██████▓▒▓██████████▓▒▒▒▒▒▒▒░░▒▒▒▒▒▒▒▒▒▒▒▓▓█████████████████████████████████████▓▓█▒░░▒▓▒▓▒▓█████▓▓▓█▓▓█▓▒█▒▓██▓███▓▒▓▒▓▓▓▓▓▓▓▓▓▓▓▓▓▓▓▒▓▓█▓▒▓▓▒▒▒▓████████████████████▓▓▓▓▓▓▓▓▓▓▓▓▓▒▒▒▒▒▒▒▒▒▒▒▒▒▒▒▒▒▒▒▒▒▒▒▒▒▒▒▒▒▒▒▒▒▒▒
▓▓▓███▓██████▓▒▓██████████▓▒▒▒▒▒▒▒░░▒▒▒▒▒▒▒▒▒▒▓▓▓█████████████████████████████████████▓▓█▒░░▒▓▓▓▒▓█████████▓▓█▓▒█▒▓▓█▓█▓▓▓▒▓▒▓▓▓▓▓▓▓▓▓▓▓▓▓▓▓▒▓▓█▓▓▓▓▒▒▒▓██████████████████████████▓▓▓▓▓▓▓▓▓▓▓▓▓▓▒▒▒▒▒▒▒▒▒▒▒▒▒▒▒▒▒▒▒▒▒▒▒▒▒▒▒▒
▓▓▓▓██▓██████▓▒▓██████████▓▒▒▒▒▒▒▒░░░▒▒▒▒▒▒▒▒▒▒▒▓█████████████████████████████████████▓▓█▒░░▒▓▓▓▒▓██████▓█▓▓▓█▓▒█▒▒░░▒▓▒▒▒▒▒▒▓▓▓▓▓▓▓▓▓▓▓▓▓▓▓▒▓▓█▓▓▓▓▒▒▒▓██████████████████████▓▓▓▓▓▓▓▓▓▓▓▓▓▒▒▒▒▒▒▒▒▒▒▒▒▒▒▒▒▒▒▒▒▒▒▒▒▒▒▒▒▒▒▒▒▒
▓▓▓▓██▓██████▓▒▓██████████▓▒▒▒▒▒▒▒░░░░░▒▒▒▒▒▒▒▒▒▒▓▓██████████████████████████████████▓▓▓█▒░░▒▓▒▓▒▓█████▓▓▓████▓▒▓▒▒░▒▒▒▒▒▒▒▒▒▓▓▓▓▓▓▓▓▓▓▓▓▓▓▓▒▓▓█▓▓█▓▒▒▒▓███████▓▓▓▓▓▓▓▓▓▓▓▓▓▓▓▓▓▓▒▒▒▒▒▒▒▒▒▒▒▒▒▒▒▒▒▒▒▒▒▒▒▒▒▒▒▒▒▒▒▒▒▒▒▒▒▒▒▒▒▒▒
▓▓▓▓██▓█▓▓███▓▒▓▓█████████▓▒▒▒▒▒▒▒░░░░░░░░▒▒▒▒▒▒▒▒▓▓█████████████████████████████████▓▓▓█▒░░▒▓▒▓▓███████████████▒░░░░▓▒░░░▒▓▓▓███▓██▓█▓██▓▓▓▒▓██▓▓██▒▒▒▓▓▓▓▓▓▓▓▓▓▓▓▓▓▓▓▓▒▒▒▒▒▒▒▒▒▒▒▒▒▒▒▒▒▒▒▒▒▒▒▒▒▒▒▒▒▒▒▒░░▒░░░▒░░░░░░░░░░░░░
▓▓▓▓██▓▓█████▓▒▓▓█████████▓▒▒▒▒▒▒▒░░░░░░░░▒▒▒▒▒▒▒▒▓▓█████████████████▓▓███████████▓██▓▓▓█▒░░▒▒▓▓▓▓▓▓▓▓▓▓▓▓▓▓▓▓▓▓▓░ ░▒▓█▒░░▒▓▓▓▓▓▓▓▓▓▓▓▓▓▓▓▓▓▓▓███▓██▒▒▒▓▓▓▓▓▓▓▓▓▓▓▓▓▓▓▓▓▒▒▒▒▒▒▓▒▒▒▒▒▒▒▒▒▒▒▒▒▒▒▒▒▒▒▒▒▒▒▒▒▒▒▒▒▒▒▒▒▒▒▒▒░░░░░░░░
▓▓▓▓██▓▓▓▓███▒▒▓▓█████████▓▒▒▒▒▒▒░░░░░░░░░░░▒▒▒▒▒▒▓▓█████████████████▓▒▓██████████▓▓██▓▓█▒░░▒▒███████████████████▓█▓█▓█▓█▓▓██████████████████████▓██▒▒▒█▓▒▒▓████▓▓▓▓▓▓▓▓▓▓▓▒▒▒▒▒▒▒▒▒▒▒▒░▒▒▒▒▒▒▒▒▒▒▒▒▒▒▒▒▒▒▒▒▒▒▒▒▒▒▒▒▒░░░▒░░▒
▓▓▓▓██▓▓▓▓▓▓▓▒▒▒▓▓████████▓▒▒▒▒▒▒░░░░░░░░░░░▒▒▒▒▒▒▓▓▓███████████████▓▓▓▓██████████▓▓██▓▓█▒░░▒▒▓█████████████████▒███▒▓▒███▓▓█████████████████████▓██▒▒▒█▓▒▒▓███████▓▓▓▓▓▓▓▓▓▓▒▒▒▒▒▒▒▒▒▒░▒▒▒▒▒▒▒▒▒▒▒▒▒▒▒▒▒▒▒▒▒▒▒▒▒▒▒▒▒░░░▒▒▒▒
▒▒▓▓▓▓▓▓▓▓▓▒▒▒▒▒▓▓████████▓▒▒▒▒▒▒░░░░░░░░░░░▒▒▒▒▒▒▒▓▓▓███████████████▓▓▓██████████▓▓██▓▓█▒░░▒▓▒▓▓▓▓▓▓▓▓▓▓▓▓▓▓▓▓▓▓▒▒▓▓▓▓▓▓▒▒▓▓▓▓▓▓▓▓▓▓▓▓▓▓▓█▓▒▓███▓██▒▒▒█▓▒▓▓███████▓▓▓▓▓▓▓▓▓▓▓▒▒▒▒▒▒▒▒▒░▒▒▒▒▒▒▒▒▒▒▒▒▒▒▒▒▒▒▒▒▒▒▒▒▒▒▒▒▒░░░▒▒▒▒
▓▓▓▓█████▓▓▓▓▓▓▓▓▓▓▓██████▓▒▒▒▒▒▒░░░░░░░░▒▓█████████▓▓██████████████▓▓▓▓██████████▓▓█▓▓▓█▒░░▒▓▒▓▒▓▓▓████▓███▓█▓▒█▒▓██▓███▓▒▓▒▓▓███▓▓█▓▓▓▓▓▓▓▒▓███▓██▒▒▒█▓▒▒████████▓▓█▓▓▓▓▓▓▓▓▓▒▒▒▓▒▒▒▒▒▒▒▒▒▒▒▒▒▒▒▒▒▒▒▒▒▓▓▓▒▒▒▒▒▒▒▒▒▒░░░▒▒▒▒
▒▒▒▒▒▒▒▒▒▒▒▒▒▒▓▓▓▓▒▓██████▓▒▒▒▒▒░░░▒▒▒▒▒░░▒█████████▒▒▒▓███▓████████▓▓▓▓██████████▓▓██▓▓█▒░░▒▓▒▓▒▓▓▓███▓▓▓▓█▓▓▓▒█▒▓██▓███▓▓▓▒▓▓██▓▓▓▓▓█▓▓▓▓▓▓▓███▓██▒▒▒█▓▒▒████████▓██▓█▓▓▓▓▓▓▓▒▓▓▓▓▒▒▒▒▒▒▒▒▒▒▒▒▒▒▒▒▒▒▒▒▒▒▒▒▒▒▓▒▒▒▒▒▒░░░▒▒▒▒
▒▒▒▒▒▒▒▒▒▒▒▒▒▒▒▒▒▒▒▒▓▓▓██▓▒▒▒▒▒▒░░▒▓▒▒░░░░▒▓███████▓▒▒▒▒▒▒▒▒▒▓▓▓▓██▓▓▓▓▓██████████▓▓█▓▓▓█▒░░▒▓▒▓▒▓▓███████████▓▒█▒▓██▓███▓▓▓▒▓██████████▓▓▓▓▓▓███▓██▒▒▒█▓▒▓███████████▓█████████▓▒▓▓▓▓▒▒▒▒▒▒▒▒▒▒▒▒▒▒▒▒▒▒▒▒▒▒▒▓▒▒▒▒▒▒▒░░░▒▒▒▒
▒▒▒▒▒▒▒▒▒▒▒▒▒▒▒▒░░░▒▒▒▒██▓▒▒▒▒▒░░░░░▒▒░░░░░▓██████▓▓▒▒▒▒▒▒▒▒▒▒▒▒▒▒▓▓▓▓▓▓██████████▓▓█▓▓▓▓▒░░▒▒▒▓▒▓██████████▓█▓▒█▒▓██▓███▓▓▓▒█████████▓▓█▓▓▓▓▓███▓██▒▒▒█▓▒▓█████████████████████▓▒▒▓▓▓▒▒▒▒▒▒▒▒▒▒▒▒▒▒▒▒▒▒▒▒▒▒▒▓▒▒▒▒▒▒▒░░░▒▒▒▒
░▒▒▒▒▒▒▒▒▒▒▒▒▒▒▒░░░▒▒▒▒▓▓▒▒▒▒▒░░░░░▒▒▒░░░▒▓██▓▓▓▓▓▓▓▒▒▒▒▒▒▒▒▒▒▒▒▒▒▒▒▒▒▒▒▓█████████▒▓█▓▓▓▓▒░░▒▒▒▓▒▓██████████▓█▓▒█▒▓██▓███▓▓▓▒█████████▓▓█▓▓▓▓▓███▓██▒▒▒█▓▒▓█████████████████████▓▒▓▓▓▓▒▒▒▓▒▒▒▒▒▒▒▒▒▒▒▒▒▒▒▒▒▒▒▓▒▒▒▒▒▒▒░░░▒▒▒▒
░▒▒▒▒▒▒▒▒▒▒▒▒▒▒▒░░░░▒▒▒▒▒▒▒▒▒░░░░░░▒▒▒▒▓██████████████▓▓▒▒▒▒▒▒▒▒▒▒▒▒▒▒▒▒▓▓▓██████▓▒▓█▓▒▓▓▒░░▒▒▒▓▒▒▓████████▓▓█▓▒█▒▓██▓███▓▓▓▒█████████▓▓█▓▓▓▓▓███▓██▒▒▓█▓▒▓████████████████▓▓▓▓█▓▒▓▓▓▓▒▒▒▓▓▓▓████████▓▓▓▓▓▒▒▒▓▒▒▒▒▒▒▒░░░░░▒▒
░▒▒▒▒▒▒▒▒▒▒▒▒▒░░░░░░▒░▒▒▒▒▒░▒░░░░░░▒▒▒█████▓▓▓▒▒▒▒▒▒░░░░░▒░░▒▒▒▒▒▒▒▒▒▒▒▒▒▒▓▓▓▓▓▓█▓▒▓█▓▒▓▓▒░░▒▒▒▓▒▓▓███████▓███▓▒█▒▓██▓███▓▓▓▒▓██████▓▓██▓▓▓▓▓▓███▓██▓▒▓█▓▒▓██████████▓▓▓▓▓▓▓▓▓▓▓▒░░▒▒▒▒▒▒▓█████████████████▓▓▓▒▒▒▒▒▒▒░░░▒▒▒▒
░▒▒▒▒▒▒▒▒▒▒░░░░░░░░░░░▒▒▒▒▒░░░░░░░░▒▒▒▓█▓▓▓▒▒▒░░░░░░░░░░░▒░░░░░▒▒▒▒▒▒▒▒▒▒▒▒▒▒▒▒▓▓▓▒▓█▓▒▓▓▒░░▒▒▒▓▒▒▓▓▓▓▓▓█▓▓▓▓█▓▒█▒▓██▓███▓▓▓▒▓▓▓▓▓▓▓▓▓▓▓█▓▓▓▓▓███▓██▓▒▓█▓▒▓█████████▓▓▓▓▓▓▓▓▓▓▓▓▒▒▒▒▒▒▒▒▒▒▒▓███████▓▒▒▓▒▒▒▒░░░▒▒▒▒▒▒▒░░░▒▒▒▒
░░▒▒▒░▒░░░░░░░░░░░░░░░░▒▒▒░░░░░░░░░▒▒░░░░░░░░░░░░░░░░░░░░░░▒▒▒▒▒▒▒▒▒▒▒▒▒▒▒▒▒▒▒▒▒▒▒▒▒▓▒▒▒▓▒░░▒▒▒▒▒▓▓▓▓▓▓▓▓▓▓▓▓▓▓▒█▒▓██▓███▓▓▓▓▓▓▓▓▓▓▓▓▓▓▓▓▓▓▓▓▓███▓██▒▒▓█▓▓████████████▓██▓▒▒▓▓▓▓▒▒▓▒▒▒▒▒▒▒▒▒▒▒▒▒▒▒▓▓▒▒▒▒▒▒▒▒▒░▒▒▒▒▒▒▒░▒▒▒▒▒▒
░░░░░░░░░░░░░░░░░░░░░░░▒▒▒░░░░░░░░░▒▒░░░░░░░░░░░░░░░░░░░░░░░░░▒▒▒▒▒▒▒▒▒▒▒▒▒▒▒▒▒▒▒▒▒▒▒▒▒▒▒▒░░▒▒▒▓▓████████████████▒▓██▓███▓▓████████████████▓▓▓███▓██▒▒▓███████████████▓███▓▓█▓▓▓▒▒▓▓▓▓▒▒▒▒▒▒▒▒▒▒▒▒▓▓▒░░░░░░░▒▒░░░▒▒▒▒▒▒▒▒▒▒▒
░░░░░░░░░░░░░░░░░░░░░░░▒▒▒░░░░░░░░░▒▒░░░░░░░░░░░░░░░░░░░░▒░░░░░░░░░░░░▒▒▒▒▒▒▒▒▒▒▒▒▒▒▒▒▒▒▒▒░░▒▒▒▒▓▓▓▓▓▓▓▓█████▓▓▓█▓███▓████▓▓▓█▓▓▓▓▓▓▓▓▓▓▓▓▓▓█████▓██▓▒▓▓████▓▓▓▓▓▓████▓▓▓▓▓▓▓▓▓▓▒▒▓▓▓▓▓▓▓▒▒▒░░░░░░▒▓▒░░░░░░░▒▒░░░░░░░░░░▒▒▒▒
░░░░░░░░░░░░░░░░░░░░░░░░░░░░░░░░░░░▒░░░░░░░░░░░░░░░░░░░░░▒░░░░░░░░░░░░░▒▒▒▒▒▒▒▒▒▒▒▒▒▒▒▒▒▒▒░░▒▒▒▒▓▓███████████████████▓███████████████████████████▓██▓▒▓███████████████▓▓▓██▓▓▓▓▓▒▒▓▓▓▓▓▓▓▒▒▒▒▒▒░░░▒▓▒░░░░░░░▒▒░░░░░░░░░░░░░░
░░░░░░░░░░░░░░░░░░░░░░░░░░░░░░░░░░░░░░░░░░░░░░░░░░░░░░░░░▒░░░░░░░░░░░░░░░▒▒▒▒▒▒▒▒▒▒▒▒▒▒▒▒▒░░░▒▒▒▒▓▓██████████████████▓███████████████████████████▓██▓▒▓██████████████▓▓▓▓▓█▓▓▓▓▓▓▒▓▓▓▓▓█▓▒▓▓▒▒▒▒▒▒▓▓▒░░░░░░░▒▒░░░░░░░░░░░░░░
░░░░░░░░░░░░░░░░░░░░░░░░░░░░░░░░░░░░░░░░░░░░░░░░░░░░░░░░░▒░░░░░░░░░░░▒▒▒▒▒▒▒▒▒▒▒▒▒▒▒▒▒▒▒▒▒▒▓▓▓▓██████████████████████████████████████████████████████▓███████████████▓█▓▓▓▓▓▓▓▓▓▓▓▓▓▓▓▓▓▓▒▓▓▓▓▓▒▒▒▓▓▒▒▒▒▒▒▒░▒▓▒░░░░░░░░░░░░░
░░░░░░░░░░░░░░░░░░░░░░░░░░░░░░░░░░░░░░░░░░░░░░░░░░▒░░░▒▒▒▒▒▒▒▒▒▒▒▒▒▒▒▒▒▒▒▒▓▓▓▓▓▓▓▓▓██████████████████████████████████████████▓▓▓▓██████████████████████████▓▓▓▓▓▓▓▓▓█▓▓▓▓███▓▓█▓▓▓▓▓▓▓██▓▓▓▓▓▓▓▓▓▓██▓▓▓▓▓▓▒▒▓▓▒▒▒░░░░░░░░░░░
░░░░░░░░░░░░░░░░░░░░░░░░░░░░░▒░░░░▒░░░▒▒▒▒▒▒▒▒▒▒▒▒▒▒▒▒▒▒▒▒▒▓▓▓▓▓▓▓▓▓▓▓▓▓████████████████▓▓▓▓▓▓▓▓▓▓▓▓▓▓▓▓▓▓▓▓▓▓▓▓▓▓▓▓▓███████████████████▓▓▓▓▓▓▓▓▓▓▓▓▓▓▓▓████████████████████████▓▓██████████████████▓▓▓▓▓▓▓▓▓▓▓▒▒▒▒▒▒▓▓▓▓▓▓▓
░░░░░░░░░░░░░░░░░░░░░░░░░░░░▒▒▒▒▒▒▒▒▒▒▒▒▒▒▒▒▒▒▓▓▓▓▓▓▓▓▓▓▓▓▓▓▓▓▓▓▓▓▓▓▓▓▓▓▓▓▓▓▓▓▓▓▓▓▓▓▓▓▓▓▓▓▓▓▓▓▓▓▓▓▓▓▓▓▓▓▓▓▓▓▓▓▓▓▓▓▓▓▓▓▓▓▓▓▓▓▓▓▓▓▓▓████████████████████████████████████████████████▓▓▓▓▓▓▓▓▒▒▒▓▓▓▓▓▓█████████████████████████
░░░░░░░░░░░░░░░░░░░░░░░▒▒▒▒▒▒▒▒▒▒▒▒▒▒▒▒▒▒▓▓▓▓▓▓▓▓▓▓▓▓▓▓▓▓▓▓▓▓▓▓▓▓▓▓▓▓▓▓▓▓▓▓▓▓▓▓▓▓▓▓▓▓▓▓▓▓▓▓▓▓▓▓▓▓▓▓▓▓▓▓▓▓▓▓▓▓▓▓▓▓▓▓▓▓▓██████████████████████████████████████████████████████▓▓▓▓▓███████████████████████████████████████████
░░░░░░░░░░░░░░░░░░▒▒▒▒▒▒▒▒▒▒▒▒▒▒▒▒▒▒▒▒▓▓▓▓▓▓▓▓▓▓▓▓▓▓▓▓▓▓▓▓▓▓▓▓▓▓▓▓▓▓▓▓▓▓▓▓▓▓▓▓▓▓▓▓▓▓▓▓▓▓▓▓▓▓▓▓▓▓▓▓▓▓▓▓▓███████████████████████████████████████████████████████▓▓▓▓▓▓▓▓██████████████████████████████████████████████████████
░░░░░░░░░░░░░░░░▒▒▒▒▒▒▒▒▒▒▒▒▒▒▒▒▒▒▒▒▓▓▓▓▓▓▓▓▓▓▓▓▓▓▓▓▓▓▓▓▓▓▓▓▓▓▓▓▓▓▓▓▓▓▓▓▓▓▓▓▓▓▓▓▓▓▓▓▓▓▓▓████▓▓▓▓███████████████████████████████████████████████▓▓▓▓▓▓▓▓▓▓███████████████████████████████████████████████████████▓▓▓▓▓▓▓▓▓▓▓▒
░░░░░░░░░░░▒▒▒▒▒▒▒▒▒▒▒▒▒▒▒▒▒▒▒▒▒▓▓▓▓▓▓▓▓▓▓▓▓▓▓▓▓▓▓▓▓▓▓▓▓▓▓▓▓▓▓▓▓▓▓▓▓▓▓▓▓▓▓▓█████████████████▓▓▓█████████████████████████████████▓▓▓▓▓▓▓▓▓▓▓▓▓▓▓▓██████████████████████████████████████████████████▓▓▓▓▓▓▓▓▓▓▓▓▒▒▒▒▒▒▒▒▒▒▒▓▓▓
