████████████████████████████████████████████████████████████████████████████████████████████████████████████████████████████████████████████████████████████████████████████████████████████████████████████████████████████
████████████████████████████████████████████████████████████████████████████████████████████████████████████████████████████████████████████████████████████████████████████████████████████████████████████████████████████
████████████████████████████████████████████████████████████████████████████████████████████████████████████████████████████████████████████████████████████████████████████████████████████████████████████████████████████
████████████████████████████████████████████████████████████████████████████████████████████████████████████████████████████████████████████████████████████████████████████████████████████████████████████████████████████
████████████████████████████████████████████████████████████████████████████████████████████████████████████████████████████████████████████████████████████████████████████████████████████████████████████████████████████
████████████████████████████████████████████████████████████████████████████████████████████████████████████████████████████████████████████████████████████████████████████████████████████████████████████████████████████
████████████████████████████████████████████████████████████████████████████████████████████████████████████████████████████████████████████████████████████████████████████████████████████████████████████████████████████
████████████████████████████████████████████████████████████████████████████████████████████████████████████████████████████████████████████████████████████████████████████████████████████████████████████████████████████
████████████████████████████████████████████████████████████████████████████████████████████████████████████████████████████████████████████████████████████████████████████████████████████████████████████████████████████
████████████████████████████████████████████████████████████████████████████████████████████████████████████████████████████████████████████████████████████████████████████████████████████████████████████████████████████
████████████████████████████████████████████████████████████████████████████████████████████████████████████████████████████████████████████████████████████████████████████████████████████████████████████████████████████
████████████████████████████████████████████████████████████████████████████████████████████████████████████████████████████████████████████████████████████████████████████████████████████████████████████████████████████
████████████████████████████████████████████████████████████████████████████████████████████████████████████████████████████████████████████████████████████████████████████████████████████████████████████████████████████
████████████████████████████████████████████████████████████████████████████████████████████████████████████████████████████████████████████████████████████████████████████████████████████████████████████████████████████
████████████████████████████████████████████████████████████████████████████████████████████████████████████████████████████████████████████████████████████████████████████████████████████████████████████████████████████
████████████████████████████████████████████████████████████████████████████████████████████████████████████████████████████████████████████████████████████████████████████████████████████████████████████████████████████
████████████████████████████████████████████████████████████████████████████████████████████████████████████████████████████████████████████████████████████████████████████████████████████████████████████████████████████
████████████████████████████████████████████████████████████████████████████████████████████████████████████████████████████████████████████████████████████████████████████████████████████████████████████████████████████
████████████████████████████████████████████████████████████████████████████████████████████████████████████████████████████████████████████████████████████████████████████████████████████████████████████████████████████
████████████████████████████████████████████████████████████████████████████████████████████████████████████████████████████████████████████████████████████████████████████████████████████████████████████████████████████
████████████████████████████████████████████████████████████████████████████████████████████████████████████████████████████████████████████████████████████████████████████████████████████████████████████████████████████
████████████████████████████████████████████████████████████████████████████████████████████████████████████████████████████████▓▒░▒███████▓████████████████████████████████████████████████████████████████████████████████
███████████████████████████████████████████████████████████████████████████████████████████████████████████████████████████████████▓▓▓▓████▓▒▓██████████████████████████████████████████████████████████████████████████████
████████████████████████████████████████████████████████████████████████████████████████████████████████████████████▒░▒▓█████▓▓███████▓████▓▓▓▓█████████████████████████████████████████████████████████████████████████████
█████████████████████████████████████████████████████████████████████████████████████████████████████████▓████████████▓▓▓██████████████████▓▓█▓▒▓███████████████████████████████████████████████████████████████████████████
████████████████████████████████████████████████████████████████████████████████████████████████████████▓▒▓▓████████████▓▓█████████████████▓░░░░▒███████████████████████████████████████████████████████████████████████████
█████████████████████████████████████████████████████████████████████████████████████████████▒▒▓██████████▓▓███████████████████████████████▓░░░░▒███████████████████████████████████████████████████████████████████████████
████████████████████████████████████████████████████████████████████████████████████████████████▓▓▓▓███████▓▓██████████████████████████████▓░░░░▒███████████████████████████████████████████████████████████████████████████
███████████████████████████████████████████████████████████████████████████████████████████▓▓████████████████████▓▒▒▒▓█████████████████████▓░░░░▒███████████████████████████████████████████████████████████████████████████
███████████████████████████████████████████████████████████████████████████████████████████▓██████████████████▓▒▒▒▒▒▒▒▒████████████████████▓░░░░▒███████████████████████████████████████████████████████████████████████████
███████████████████████████████████████████████████████████████████████████████████████████▓█████████████████▓▒▒▓███▒▒▒████████████████████▓░░░░░███████████████████████████████████████████████████████████████████████████
███████████████████████████████████████████████████████████████████████████████████████████▓█████████████████▓▒▒▒█▓▒▒▒█████████████████████▓░░░░▒███████████████████████████████████████████████████████████████████████████
███████████████████████████████████████████████████████████████████████████████████████████▓██████████████████▓▒▒▒▒▒▒▒████████████▓▓▓███▓██▓░░░░▒███████████████████████████████████████████████████████████████████████████
███████████████████████████████████████████████████████████████████████████████████████████▓██████████████████▓▒▒▓▓▓▒▒▒▓██████████▓▓▓▓▓▓▓██▓░░▒▒▒▓██████████████████████████████████████████████████████████████████████████
███████████████████████████████████████████████████████████████████████████████████████████▓█████████████████▒▒▒████▓░▒▓█████████▓▓▓▓▓▓▓▓██▓▒██▓▒▓██████████████████████████████████████████████████████████████████████████
███████████████████████████████████████████████████████████████████████████████████████████▓█████████████████▒░▒▓█▓▓▒▒▒█████████▓▓▓▓▓▓▓▓▓██▓▒▓▒▓▓▓██████████████████████████████████████████████████████████████████████████
███████████████████████████████████████████████████████████████████████████████████████████▓█████████████████▓▒▒▒░▒▒▒▒████████▓▓▓▓▓▓▓▓▓▓▓██▓▒▒░▒▒███████████████████████████████████████████████████████████████████████████
███████████████████████████████████████████████████████████████████████████████████████████████████████████████▓▓▓▓██████▓▓▓▓▓▓▓▓▓▓▓▓▓▓▓▓▓█▓░░░░░███████████████████████████████████████████████████████████████████████████
██████████████████████████████████████████████████████████████████████████████████████████████████████████████████████▓▓▓▓▓▓▓▓▓▓▓▓▓▓▓▓▓▓▓██▓░░░░▒███████████████████████████████████████████████████████████████████████████
████████████████████████████████████████████████████████████████████████████████████████████████████████████████████▓▓▓▓▓▓▓▓▓▓████████▓▓▒▒░░░░░░▒███████████████████████████████████████████████████████████████████████████
█████████████████████████████████████████████████████████████████████████████████████████████████████████████████▓▓████████▓▓▒▒▒▒▒▒░░░░░░▒░░░░░▒▒▓██████████████████████████████████████████████████████████████████████████
████████████████████████████████████████████████████████████████████████████████████████████████████████████████▓▓▓▓▒▒░░░░░░░░░░░░░░░░░░▒▒▒▒▒▒▒▒▒▒▒▒▓███████████████████████████████████████████████████████████████████████
█████████████████████████████████████████████████████████████████████████████████████████████████████▓▓▓▓▒▒░░░░░░░░░░░░░░░░░░░▒▒▒▒▒▒░▒▒▒▒▒░▒▓▓▓█████████████████████████████████████████████████████████████████████████████
▓▓▓████████████████████████████████████████████████████████████████████████████████████████▓▓▓▓▒▒░░░▒▒░░░░░░░░░░░░░▒▓█░░░░▒▒▒░▒▒▓▓▓▒▒███████████████████████████████████████████████████████████████████████████████████████
▓▓▓▒▒▓████████████████████████████████████████████████████████████████████████████████▓▓▒▒▒▒▒▒▒▒▒▒▒▒▒▓▓▒▒░▒▒▒▒▒▒▒░░▒▓█░░░▓██▓▒██▒▓▓▓▒███████████████████████████████████████████████████████████████████████████████████████
▒▒▒▒▒▒▒▒▒▒▒▓██████████████████████████████████████████████████████████████████████████████▓▒░▒▒▒▒▒▒▒▒▒▒▒▒░▒▒░░▒▓▒▒░░░░░░░▓██▓▒██▓▓▒▓▒███████████████████████████████████████████████████████████████████████████████████████
▒▒▒▒▒▒▒▒▒▒▒▒▒▒██████████████████████████████████████████████████████████████████████████████████▓▓▓███▓█▓░░▓██▓▒▒▒▒▒▒▒▒▒░░░▒▒▒▒▓███▒▒███████████████████████████████████████████████████████████████████████████████████████
▒▒▒▒▒▒▒▒▒▒▒▒▒▒▒▓██████████████████████████████████████████████████████████████████████████████████████▒▒▓██▓▓▒▒▒▒▒▒▒▒▒▒▒░░▒░░░░░░░░░░░▒▒▒▓▓▓▓▓▒▒▒▓████████████████████████████████████████████████▓▒▓████████▒▓▓▓████████▓▒░
▒▒▒▒▒▒▒▒▒▒▒▒▒▒▒▒▒███████████████████████████████████████████████████████████████████████████████████▓▓██▓█▓▒▒▓▒▒▒▒▒▒▒▒▒▒▒▒▒▒░░░░░░▒░░░░░▒▒▓██▓▒▒▒▒▒▒▒▒▓█████████████████████████████████████████▓▒▓█▓▓▓▓▓▓▓▓▒░░░░░░░░░░░░░▓█
▒▒▒▒▒▒▒▒▒▒▒▒▒▒▒▒▒▒▓████████████████████████████████████████████████████████████████████████████████▓█████▓▒▓▓▒▒▒▒░░░▒▒▒▒▒▒▒▒▒░▒▒▒▒▒░░░░░░░░▒▒▒▒▒▒▒▒▒░▒▒░░▒▓███████████████████████████████████▓▒▓▓▓▒▒▒▒▒▒▒▒▒▒▒▒▒░░▒▒▒▒▒▒▓███
▒▒▒▒▒▒▒▒▒▒▒▒▒▒▒▒▒▒▒▒█████████████████████████████████████████████████████████████████████████████▓█▓████▓▓██▒▒▒▒▒░░░░▒▒▒▒▒▒▒▒▒░░░░░░░░░░░░░░░░░▒▒▒▒▒▒░░░░░░▒▓██████████████████████████████▓▓▓▓▓▓▒░░░░▒░▒▒▓▓▒▒░░░░░░░▒▒▒▓▓▒▓
▒▒▒▒▒▒▒▒▒▒▒▒▒▒▒▒▒▒▒▒▒▒█████████████████████████████████████████████████████████████████████████▓▓█▓███████▓▒▒▒▒▒▒░░░░░▒▒▒▒▒▒▒░░░░░░░░░░░░░░░░░░▒▒▒▒▒▒▒▒▒░░░░░░░▒▓█████████████████████████▓█▓▓▓▓▓░░░░░░░░░▒▒░░░░░░░░▒▒▒▒░▒▒▒
▒▒▒▒▒▒▒▒▒▒▒▒▒▒▒▒▒▒▒▒▒▒▒▒▓███████████████████████████████████████████████████████████████████▓▒▒██████████▓▒▒▒▒▒▒░░░░░░░░▒▒▒▒░░░░░░░░░░░░░░░░░░░▒▒▒▒▒▒▒▒░░░░░░░░░░░▒▓▓▓██████████████████▓▓█▓▓▒▓█▒░░▒░░░░░░░░░░░░░░░░░░░░░░░░
▒▒▒▒▒▒▒▒▒▒▒▒▒▒▒▒▒▒▒▒▒▒▒▒▒▓█████████████████████████████████████████████████████████████████▓███████▓████▓▒▒▒▒▒▒░▒░░░░░░░░▒▒▒░░░░░░░░░░░░░░░░░░░░░░▒▒▒░░░░░░░░░░░░░░░░░░░▒██████████████▓▓▓▒▒▒▒▒▒▒░░░░░░░░░░░░░░░░░░░░░░░░░░░
▒▒▒▒▒▒▒▒▒▒░▒▒▒▒▒▒▒▒▒▒▒▒▒▒▒▒▓█████████████████████████████████████████████████████████████▓███▓███▓▓███▓▒▒▒▒▒▒▒░░░░░░░░░░░░▒▒▒▒░░░░░░░░░░░░░░░░░░░░▒▒▒▒▒░░░░░░░░░░░░░░░░▒░░░░▓█████▓░▒▓▒▒▒▒▒▒▒▒▒▒▒░░░░░░░░░░░░░░░░░░░░░░░░░▒▒
▒▒▒▒▒▒▒░░▒▒▒▒▒▒▒▒▒▒▒▒▒▒▒▒▒▒▒▒██████████████████████████████████████████████████████████▓▓█████▓▒▓████▓▒▒▒▒▒▒░░░░░░░░░░░░░░░░░░░░░░░░░░░░░░░░░░░░░▒░░░░▒▒▒▒░░░░░░░░░░░░░░░▒░░░░░░░░▒▓██▓▒▒▒▒▒░▒▒░░░░░░░░░░░░░░░░░░░░░░░░░▒▒▒▒
▒▒▒▒░░▒▒▒▒▒▒▒▒▒▒▒▒▒▒▒▒▒▒▒▒▒▒▒░▒▓████▓▓▒▒▓████████████████████████████████████████████▓▒▓██▓▒▒▒▓▓███▓▒▒▒▒▒▒▒░░▒▓▒░░░░░░░░░░░░░░░░░░░░░░░░░░░░░░░░░░░░░░░░▒▒▒▒░░░░░░░░░░░░░░░░░░░░░░░░░▒▒▒▒▒░░▒▒░░░░░░░░░░░░░░░░░░░░░░░░░▒▒▒░░
▒▒░░▒▒▒▒▒▒▒▒▒▒▒▒▒▒▒▒▒▒▒▒▒▒▒▒▒▒▒░░▒▒▒▒▒▒▒▒▒█████████▓███████████████████████████▓▒▒▒▓▓▓██▓▒▒▒▒▓██▓▓▒▒▒▒▒▒▒▒▒▒▓▓▒░░░░░░░░░░░░░░░░░░░░░░░░░░░░░░░░░░░░░░░░░░░░░▒░░░░░░░░░░░░░░░▒▒▒▒▒░░▒▒▒▒▒▒▒░░▒░░░░░░░░░░░░░░░░░▒▒░░░░▒▓▓▒▒▒▒░
░░▒▒▒▒▒▒▒▒▒▒▒▒▒▒▒▒▒▒▒▒▒▒▒▒▒▒░▒▒▒▒░▒▒▒▒▒▒▒▒▒▒▓▓▓▓▓▓▓▒░▒▓███████████████████████▓▓██▓▓▓▓▒▒▒▒▒▓██▓▓▒▒▒▒▒▒▒▒▒▓█▓▒▒▒░▒░░░░░░░░░░░░░░░░░░░░▒▒▒▒▒▒░░░░░░░░░░░░░░░░░░░▒░░░░░░░░░░░░▒▒▒▒▒▒▒▒▒▒▒▒▒░░░░░░░░░░░░░░░░░░░░░▒▒▒▒▒▒▒▒▒░▒▒▒▒░
░▒▒▒▒▒▒▒▒░▒▒▒▒▒▒▒▒▒▒▒▒▒▒▒▒▒░░░░▒▒▒▒▒▒▒▒▒▒▒▓▓█████▓▒▒▒▒░░▒▓██████████████████▓▓█▓▓▒▒▒▒▒▒▒▒▒▓█▓▓▒▒▒▒▒▒▒▒▓▓██▓▒▒▒▒▒░░░░░░░░░░░░░░░░░░░░░░░▒▒▒▒▒▒▒░░░░░░░░░░░░░░░░░░░░░░░░░░░░░░░▒▒▒▒▒▒▒▒▒▒░░░░░░░░░░░░░░░░░░░░░▒▒░░░▒▒▒░░░░▒▒░░
▒▒▒▒▒▒▒▒░▒▒▒▒▒▒▒▒▒▒▒▒▒▒▒▒▒▒▒▒▒▒▒▒▒▒▒▒▒▒▒▒▒▒▓▓▓█▓▒▒▒▒▒▒▒▒▒░░▒▓█████████████▓▓█▓▒▒▒▒▒▒▒▒▒▒▒▓▓▒▒▒▒▓▓▒▒▒▓███▓▒▒▓▒▒▒▒░░░░░░░░░░░░░░▒▒▒░░░░░░░░░░░░▒▒░░░░░░░░░░░░░░░░░░░░░░░░░░░░░░▒▒▒▒▒▒▒▒░░░░░░░░░░░░░░░░░░░░▒▒▒░░░░▒▒▒░░░░░░░░░
▒▒▒▒▒▒▒░▒▒▒▒▒▒▒▒▒▒▒▒▒▒▒▒▒▒▒▒▒▒▒▒▒▒▒▒▒▒▒▒▒▒▒▒▒▒▒▒▒▒▒▒▒▒▒▒░░░░░░░▒██████▓▓▒▓█▓▓▒▒▒▒▒▒▒▒▒▒▒▒▒▒▒▒▒▓▓▒▒▓███▓▒▒▒▒▒▒▒▒░░░░░░░░░░░░░▒▒▒░░░░░░░░░░░░░░░░░░░░░░░░░░░░░░░░░░░░░░░░░░░░▒▒▒▒░░░░░░░░░░░░░░░░░░░░░░▒▒▒▒▒▒░░░░▒▒▒░░░░░░░░░░
▒▒▒▒▒▒░▒▒▒▒▒▒▒▒▒▒▒▒▒▒▒▒▒▒▒▒▒▒▒▒▒▒▒▒▒▒▒▒▒▒▒▒▒▒▒▒▒▒▒▒▒▒▒░░░░░░░░░░░░▓█▓▒▓▓▓▓▒▒▒▒▒▒▒▒▒▒▒▒▒▒░░▒▒▓▓▒▒▓██▓▒▒▒▒▒▒▒▒░▒░░░░░░░░░░░░░▒░░░░░░░░░░░░░░░░░░░░░░░░░░░░░░░░░░░░░░░░░░░░▒▒▒▒▒░░░░░░░░░░░░░░░░░░░░░░▒▒▒▒▒▒░░░░░▒▒▒░░░░░░░░░░░
▒▒▒▒░▒▒▒▒▒▒▒▒▒▒▒░▒▒▒▒▒▒▒▒▒▒░░░▒▒▒▒▒▒▒▒▒▒▒▒▒▒▒▒▒▒▒▒▒▒░░░░░░░░░░░░░░░▒▓▒▒▒▒▒▒▒▒▒▒▒▒▒▒▒▒▒░░░▒▒▒▒▒▓▓▓▒▒▒▒▒▒▒▒░░░▒░░░░░░░░░░░░░░░░░░░░░░░░░░░░░░░░░░░░░░░░░░░░░░░░░░░░░░░░░▒▒░░░░░░░░░░░░░░░░░░░░░░░░░░▒▒▒▒▒░░░░░░░▒░░░░░░░░░░░░░