▓█▓█▓████████████████████████████████████████████████████████████████████████████████████████████████████████████████████████████████████████████████████████████████████████████████████████▓▓▓▓▓▓▓▓▓▓▓▓███████████████████
▓█▓██▓█▓██████████████████████████████████████████████████████████████████████████████████████████████████████████████████████████████████████████████████████████████████████████████████████▓▓▓▓▓▓▓▓▓▓████████████████████
█▓█▓█████▓█▓█████████████████████████████████████████████████████████████████████████████████████████████████████████████████████████████████████████████████████████████████████████████████▓▓▓▓▓▓▓▓▓▓▓▓███████████████████
▓███▓█▓███████████████████████████████████████████████████████████████████████████████████████████████████████████████████████████████████████████████████████████████████████████████████████▓▓▓▓▓▓▓▓▓▓████████████████████
█▓█▓█████████████████████████████████████████████████████████████████████████████████████████████████████████████████████████████████████████████████████████████████████████████████████████▓▓▓▓▓▓▓▓▓▓▓████████████████████
█▓██▓█▓█▓█▓██████████████████████████████████████████████████████████▓▓▓▓▓▓▓▓▓▓▓▓▓▓▓▓▓▓▓▓▓▓▓▓▓▓▓▓▓▓▓▓▓▓▓▓▓▓▓▓▓▓▓▓█▓█▓█▓███████████████████████████████████████████████████████████████████████▓▓▓▓▓▓▓▓▓▓▓███████████████████
█▓██████████████████████████████████████████████████████████████████▓▓▒▒▒▒▒▒▒▒▒▓▒▓▒▓▒▓▓▓▓▓▓▓▓▓▓▓▓▓▓▓▓▓▓▓▓▓▓▓▓▓▓▓▓▓▓▓▓▓▓▓▓▓▓▓▓▓▓▓▓▓▓▓▓▓▓▓▓▓▓▓▓▓▓▓▓▓▓▓▓▓███████████████████████████████████████▓▓▓▓▓▓▓▓▓▓▓████████████████████
█▓█▓████████████████████████████████████████████████████████████████▓▓▒▒▒▒▒▒▒▒▒▒▒▒▒▒▒▓▒▓▒▓▓▓▓▓▓▓▓▓▓▓▓▓▓▓▓▓▓▓▓▓▓▓▓▓▓▓▓▓▓▓▓▓▓▓▓▓▓▓▓▓▓▓▓▓▓▓▓▓▓▓▓▓▓▓▓▓▓▓▓▓████████████████████████████████████████▓▓▓▓▓▓▓▓▓▓████████████████████
████▓█▓█▓███████████████████████████████████████████████████████████▓▓▒▒▒▓▓▒▒▒▒▒▒▒▒▒▒▒▒▒▒▒▒▒▒▒▒▒▒▒▒▒▒▒▒▒▒▓▓▓▓▒▓▓▓▓▓▓▓▓▓▓▓▓▓▓▓▓▓▓▓▓▓▓▓▓▓▓▓▓▓▓▓▓▓▓▒▓▓▓▓▓████████████████████████████████████████▓▓▓▓▓▓▓▓▓▓████████████████████
▓█▓█████████████████████████████████████████████████████████████████▓▓▒▒▒▓▓▒▓▓▓▒▓▒▓▓▓▓▓▓▓▓▓▓▓▓▓▓▓▓▓▓▓▓▓▓▓▓▓▓▓▓▓▓▓▓▓▓▓▓▓▓▓▓▓▓▓▓▓▓▓▓▓▓▓▓▓▓▓▓▓▓▓▓▓▓▓▓▓▓▓▓████████████████████████████████████████▓▓▓▓▓▓▓▓▓▓████████████████████
███▓████████████████████████████████████████████████████████████████▓▓▒▒▒▓▓▒▓▓▓▓▒▒▒▓▒▓▓▓▓▓▓▓▓▓▓▓▓▓▓▓▓▓▓▓▓▓▓▓▓▓▓▓▓▓▓▓▓▓▓▓▓▓▓▓▓▓▓▓▓▓▓▓▓▓▓▓▓▓▓▓▓▓▓▓▒▓▓▓▓▓████████████████████████████████████████▓▓▓▓▓▓▓▓▓▓████████████████████
▓████▓██████████████████████████████████████████████████████████████▓▓▒▒▒▓▓▒▓▓▓▓▓▒▒▒▒▒▒▒▒▒▒▓▒▓▒▓▓▓▓▓▓▓▓▓▒▓▓▓▓▓▓▓▓▓▓▓▓▓▓▓▓▓▓▓▓▓▓▓▓▓▓▓▓▓▓▓▓▓▓▓▓▓▓▓▒▓▓▓▓▓████████████████████████████████████████▓▓▓▓▓▓▓▓▓▓████████████████████
█▓█▓████████████████████████████████████████████████████████████████▓▓▒▒▓▓▓▒▓▓▓▓▓▓▒▒▓▓▓▓▓▓▓▓▓▓▓▓▓▓▓▓▓▓▓▒▓▓▓▓▓▓▓▓▓▓▓▓▓▓▓▓▓▓▓▓▓▓▓▓▓▓▓▓▓▓▓▓▓▓▓▓▓▓▓▓▒▓▓▓▓▓████████████████████████████████████████▓▓▓▓▓▓▓▓▓▓████████████████████
██████▓█████████████████████████████████████████████████████████████▓▓▒▓▒▓▓▒▓▓▓▓▓▓▒▒▓▓▓▓▓▓▓▓▓▓▓▓▓▓▓▓▓▓▓▒▒▓▓▓▓▓▓▓▓▓▓▓▓▓▓▓▓▓▓▓▓▓▓▓▓▓▓▓▓▓▓▓▓▓▓▓▓▓▓▓▒▓▓▓▓█████████████████████████████████████████▓▓▓▓▓▓▓▓▓▓████████████████████
▓█▓█████████████████████████████████████████████████████████████████▓▓▒▓▓▓▓▒▓▓▓▓▓▓▒▒▓▓▓▓▓▓▓▓▓▓▓▓▓▓▓▓▓▓▓▒▓▓▓▓▓▓▓▓▓▓▓▓▓▓▓▓▓▓▓▓▓▓▓▓▓▓▓▓▓▓▓▓▓▓▓▓▓▓▓▓▒▓▓▓▓▓████████████████████████████████████████▓▓▓▓▓▓▓▓▓▓████████████████████
████▓███████████████████████████████████████████████████████████████▓▓▒▒▓▓▓▒▓▓▓▓▓▓▒▒▓▓▓▓▓▓▓▓▓▓▓▓▓▓▓▓▓▓▓▒▒▓▓▓▓▓▓▓▓▓▓▓▓▓▓▓▓▓▓▓▓▓▓▓▓▓▓▓▓▓▓▓▓▓▓▓▓▓▓▓▒▓▓▓▓█████████████████████████████████████████▓▓▓▓▓▓▓▓▓▓████████████████████
█▓████▓█████████████████████████████████████████████████████████████▓▓▓▓▓▓▓▒▓▓▓▓▓▓▒▒▓▓▓▓▓▓▓▓▓▓▓▓▓▓▓▓▓▓▓▒▒▓▓▓▓▓▓▓▓▓▓▓▓▓▓▓▓▓▓▓▓▓▓▓▓▓▓▓▓▓▓▓▓▓▓▓▓▓▓▓▓▓▓▓▓█████████████████████████████████████████▓▓▓▓▓▓▓▓▓▓████████████████████
▓█▓█▓███████████████████████████████████████████████████████████████▓▓▓▒▓▓▓▒▓▓▓▓▓▓▒▒▓▓▓▓▓▓▓▓▓▓▓▓▓▓▓▓▓▓▓▒▓▓▓▓▓▓▓▓▓▓▓▓▓▓▓▓▓▓▓▓▓▓▓▓▓▓▓▓▓▓▓▓▓▓▓▓▓▓▓▓▒▓▓▓▓█████████████████████████████████████████▓▓▓▓▓▓▓▓▓▓████████████████████
███████▓████████████████████████████████████████████████████████████▓▓▓▓▓▓▓▒▓▓▓▓▓▓▒▒▓▓▓▓▓▓▓▓▓▓▓▓▓▓▓▓▓▓▓▒▒▓▓▓▓▓▓▓▓▓▓▓▓▓▓▓▓▓▓▓▓▓▓▓▓▓▓▓▓▓▓▓▓▓▓▓▓▓▓▓▓▓▓▓▓█████████████████████████████████████████▓▓▓▓▓▓▓▓▓▓████████████████████
▓█▓█▓███████████████████████████████████████████████████████████████▓▓▓▓▓▓▓▒▓▓▓▓▓▓▒▓▓▓▓▓▓▓▓▓▓▓▓▓▓▓▓▓▓▓▓▒▓▓▓▓▓▓▓▓▓▓▓▓▓▓▓▓▓▓▓▓▓▓▓▓▓▓▓▓▓▓▓▓▓▓▓▓▓▓▓▓▒▓▓▓▓█████████████████████████████████████████▓▓▓▓▓▓▓▓▓▓████████████████████
█▓█████▓█▓██████████████████████████████████████████████████████████▓▓▓▓▓▓▒▒▓▓▓▓▓▓▒▒▓▓▓▓▓▓▓▓▓▓▓▓▓▓▓▓▓▓▓▒▒▓▓▓▓▓▓▓▓▓▓▓▓▓▓▓▓▓▓▓▓▓▓▓▓▓▓▓▓▓▓▓█▓▓▓▓▓▓▓▒▓▓▓▓█████████████████████████████████████████▓▓▓▓▓▓▓▓▓▓████████████████████
▓█▓█▓███████████████████████████████████████████████████████████████▓▓▓▓▓▒▒▒▒▓▓▓▓▓▒▒▓▓▓▓▓▓▓▓▓▓▓▓▓▓▓▓▓▓▓▒▓▓▓▓▓▓▓▓▓▓▓▓▓▓▓▓▓▓▓▓▓▓▓▓▓▓▓▓▓▓▓▓▓▓▓▓▓▓▓▓▒▒▓▓▓█████████████████████████████████████████▓▓▓▓▓▓▓▓▓▓████████████████████
█████▓██████████████████████████████████████████████████████████████▓▓▓▓▓▒▒▒▒▓▓▓▓▓▓▒▓▓▓▓▓▓▓▓▓▓▓▓▓▓▓▓▓▓▓▒▒▓▓▓▓▓▓▓▓▓▓▓▓▓▓▓▓▓▓▓▓▓▓▓▓▓▓▓▓▓▓▓█▓▓▓▓▓▓▓▒▓▓▓▓█████████████████████████████████████████▓▓▓▓▓▓▓▓▓▓████████████████████
▓█▓█▓██▓██▓█████████████████████████████████████████████████████████▓▓▓▓▓▓▓▒▓▓▓▓▓▓▒▓▓▓▓▓▓▓▓▓▓▓▓▓▓▓▓▓▓▓▓▒▓▓▓▓▓▓▓▓▓▓▓▓▓▓▓▓▓▓▓▓▓▓▓▓▓▓▓▓▓▓▓▓█▓▓▓▓▓▓▓▒▓▓▓▓█████████████████████████████████████████▓▓▓▓▓▓▓▓▓▓████████████████████
▓█▓██▓██████████████████████████████████████████████████████████████▓▓▓▓▓▓▓▒▓▓▓▓▓▓▓▒▓▓▓▓▓▓▓▓▓▓▓▓▓▓▓▓▓▓▓▒▓▓▓▓▓▓▓▓▓▓▓▓▓▓▓▓▓▓▓▓▓▓▓▓▓▓▓▓▓▓▓▓█▓▓▓▓▓▓▓▓▓▓▓▓█████████████████████████████████████████▓▓▓▓▓▓▓▓▓▓████████████████████
▓██▓██▓█▓███████████████████████████████████████████████████████████▓▓▓▓▓▓▓▒▓▓▓▓▓▓▒▓▓▓▓▓▓▓▓▓▓▓▓▓▓▓▓▓▓▓▓▒▒▓▓▓▓▓▓▓▓▓▓▓▓▓▓▓▓▓▓▓▓▓▓▓▓▓▓▓▓▓▓▓█▓▓▓▓▓▓▓▓▓▓▓▓█████████████████████████████████████████▓▓▓▓▓▓▓▓▓▓████████████████████
▓▓██▓████▓██▓███████████████████████████████████████████████████████▓▓▓▓▓▓▓▒▓▓▓▓▓▓▓▒▓▓▓▓▓▓▓▓▓▓▓▓▓▓▓▓▓▓▓▒▓▓▓▓▓▓▓▓▓▓▓▓▓▓▓▓▓▓▓▓▓▓▓▓▓▓▓▓▓▓▓▓█▓▓▓▓▓▓▓▓▓▓█▓█████████████████████████████████████████▓▓▓▓▓▓▓▓▓▓████████████████████
▓█▓█▓█▓█▓███████████████████████████████████████████████████████████▓▓▓▓▓▓▓▒▓▓▓▓▓▓▓▒▓▓▓▓▓▓▓▓▓▓▓▓▓▓▓▓▓▓▓▓▒▓▓▓▓▓▓▓▓▓▓▓▓▓▓▓▓▓▓▓▓▓▓▓▓▓▓▓▓▓▓▓█▓▓▓▓▓▓▓▓▓██▓█████████████████████████████████████████▓▓▓▓▓▓▓▓▓▓████████████████████
▓█▓▓█▓█▓█▓█▓████████████████████████████████████████████████████████▓▓▓▓▓▓▓▒▓▓▓▓▓▓▓▒▓▓▓▓▓▓▓▓▓▓▓▓▓▓▓▓▓▓▓▒▓▓▓▓▓▓▓▓▓▓▓▓▓▓▓▓▓▓▓▓▓▓▓▓▓▓▓▓▓▓▓▓█▓▓▓▓▓██▓▓██▓█████████████████████████████████████████▓▓▓▓▓▓▓▓▓▓████████████████████
▓▓█▓█▓██████▓███████████████████████████████████████████████████████▓▓▓▓▓▓▓▒▓▓▓▓▓▓▓▓▓▓▓▓▓▓▓▓▓▓▓▓▓▓▓▓▓▓▓▒▒▓▓▓▓▓▓▓▓▓▓▓▓▓▓▓▓▓▓▓▓▓▓▓▓▓▓▓▓▓▓▓█▓▓▓▓███▓▓██▓█████████████████████████████████████████▓▓▓▓▓▓▓▓▓▓████████████████████
▓█▓█▓█▓█▓█▓█████████████████████████████████████████████████████████▓▓▓▓▓▓▓▒▓▓▓▓▓▓▓▒▓▓▓▓▓▓▓▓▓▓▓▓▓▓▓▓▓▓▓▒▓▓▓▓▓▓▓▓▓▓▓▓▓▓▓▓▓▓▓▓▓▓▓▓▓▓▓▓▓▓▓▓██▓▓████▓▓████████████████████████████████████████████▓▓▓▓▓▓▓▓▓▓████████████████████
▓▓▓▓█▓█▓█▓█▓█▓██▓███████████████████████████████████████████████████▓▓▓▓▓▓▓▒▓▓▓▓▓▓▓▒▓▓▓▓▓▓▓▓▓▓▓▓▓▓▓▓▓▓▓▓▒▓▓▓▓▓▓▓▓▓▓▓▓▓▓▓▓▓▓▓▓▓▓▓▓▓▓▓▓▓▓▓██▓▓████▓▓██▓█████████████████████████████████████████▓▓▓▓▓▓▓▓▓▓████████████████████
▓█▓█▓▓█▓████████████████████████████████████████████████████████████▓▓▓▓▓▓▓▒▓▓▓▓▓▓▓▒▓▓▓▓▓▓▓▓▓▓▓▓▓▓▓▓▓▓▓▒▓▓▓▓▓▓▓▓▓▓▓▓▓▓▓▓▓▓▓▓▓▓▓▓▓▓▓▓▓▓████▓▓████▓▓████████████████████████████████████████████▓▓▓▓▓▓▓▓▓▓████████████████████
▓▓█▓█▓▓█▓█▓█▓█▓██▓██████████████████████████████████████████████████▓▓▓▓▓▓▓▒▓▓▓▓▓▓▓▒▓▓▓▓▓▓▓▓▓▓▓▓▓▓▓▓▓▓▓▒▓▓▓▓▓▓▓▓▓▓▓▓▓▓▓▓▓▓▓▓▓▓▓▓▓▓▓▓██████▓▓████▓▓██▓█████████████████████████████████████████▓▓▓▓▓▓▓▓▓▓████████████████████
▓▓▓▓▓█▓▓█▓█▓███▓███▓████████████████████████████████████████████████▓▓▓▓▓▓▓▒▓▓▓▓▓▓▓▒▓▓▓▓▓▓▓▓▓▓▓▓▓▓▓▓▓▓▓▒▓▓▓▓▓▓▓▓▓▓▓▓▓▓▓▓▓▓▓▓▓▓▓▓▓▓████████▓▓████▓▓████████████████████████████████████████████▓▓▓▓▓▓▓▓▓▓████████████████████
▓▓█▓█▓█▓▓█▓█▓█▓██▓███▓██████████████████████████████████████████████▓▓▓▓▓▓▓▒▓▓▓▓▓▓▓▒▓▓▓▓▓▓▓▓▓▓▓▓▓▓▓▓▓▓▓▓▒▓▓▓▓▓▓▓▓▓▓▓▓▓▓▓▓▓▓▓▓▓▓███████████▓▓████▓▓██▓█████████████████████████████████████████▓▓▓▓▓▓▓▓▓▓████████████████████
▓▓▓▓▓▓▓█▓▓█▓█▓█▓███▓████████████████████████████████████████████████▓▓▓▓▓▓▓▒▓▓▓▓▓▓▓▒▓▓▓▓▓▓▓▓▓▓▓▓▓▓▓▓▓▓▓▒▓▓▓▓▓▓▓▓▓▓▓▓▓▓▓▓▓▓▓▓▓▓████████████▓▓████▓▓████████████████████████████████████████████▓▓▓▓▓▓▓▓▓▓████████████████████
▓█▓█▓█▓▓█▓▓█▓█▓██▓███▓█▓████████████████████████████████████████████▓▓▓▓▓▓▓▒▓▓▓▓▓▓▓▒▓▓▓▓▓▓▓▓▓▓▓▓▓▓▓▓▓▓▓▒▓▓▓▓▓▓▓▓▓▓▓▓▓▓▓▓▓▓▓▓██████████████▓▓████▓▓██▓█████████████████████████████████████████▓▓▓▓▓▓▓▓▓▓████████████████████
▓▓▓▓▓▓█▓▓█▓█▓██▓██▓█████████████████████████████████████████████████▓▓▓▓▓▓▓▒▓▓▓▓▓▓▓▒▓▓▒▓▓▓▓▓▓▓▓▓▓▓▓▒▒▓▓▒▒▓▓▒▒▒▒▒▓▓▓▓▓▓▓▓▓▓▓▓▓▓▓▓▓▓▓▓▓▓▓███▓▓████▓▓████████████████████████████████████████████▓▓▓▓▓▓▓▓▓▓████████████████████
▓▓▓▓█▓▓▓▓█▓█▓█▓█▓██▓█▓██▓███████████████████████████████████████████▓▓▓▓▓▓▓▒▓▓▓▓▓▓▓▓▓▓▓▓▓▓▓▓▓▓▓▓▓▓▓▒▒▒▒▒▒▒▒▒▒▒▒▒▒▓▓▓▓▓▓▓███████████████████▓████▓▓██▓█████████████████████████████████████████▓▓▓▓▓▓▓▓▓▓████████████████████
▓█▓▓▓▓▓█▓▓▓▓█▓█▓█▓██████████████████████████████████████████████████▓▓▓▒▓▓▓▒▓▓▓▓▓▓▓▓▓▓▓▓▓▓▓▓▓▓▓▓▓▓▓▓▓▓▓▓▓▓▒▒▒▒▒▒▓▓▓▓▓███████████████████████████▓▓████████████████████████████████████████████▓▓▓▓▓▓▓▓▓▓████████████████████
▓▓█▓▓█▓▓▓▓█▓▓▓█▓█▓█▓█▓█▓█▓██████████████████████████████████████████▓▓▓▒▓▓▓▒▓▓▓▓▓▓▓▓▓▓▓▓▓▓▓▓▓▓▓▓▓▓▓▓▓▓▓▓▓▒▒▒▒▒▒▒▓▓▓██▓██████████████████████████▓▓██▓█████████████████████████████████████████▓▓▓▓▓▓▓▓▓▓████████████████████
▓▓▓█▓▓▓▓▓▓▓▓█▓█▓██▓█████████████████████████████████████████████████▓▓▓▒▓▓▓▒▓▓▓▓▓▓▓▓▓▓▓▓▓▓▓▓▓▓▓▓▓▓▓▓▓▓▓▓▒▒▒▒▒▒▒▒▒▓██████████████████████████████▓▓████████████████████████████████████████████▓▓▓▓▓▓▓▓▓▓████████████████████
▓▓▓▓▓▓▓▓▓▓█▓▓▓▓█▓█▓█▓█▓██▓██████████████████████████████████████████▓▓▒▒▒▓▓▒▓▓▓▓▓▓▓▓▓▓▓▓▓▓▓▓▓▓▓▓▓▓▓▓▓▓▓▒▒▒▒▒▒▒▒▒▒▓██████████████████████████████▓▓██▓█████████████████████████████████████████▓▓▓▓▓▓▓▓▓▓████████████████████
▓▓▓▓▓▓▓▓▓▓▓▓▓█▓█▓██████▓███▓████████████████████████████████████████▓▓▒▒▒▓▓▒▓▓▒▓▓▓▓▓▓▓▓▓▓▓▓▓▓▓▓▓▓▓▓▓▓▒▒▒▒▒▒▒▒▒▒▒▓▓██▓▓▓▓▓▓▓▓▓▓▓▓▓▓█▓█▓▓▓█▓▓▓████▓▓████████████████████████████████████████████▓▓▓▓▓▓▓▓▓▓████████████████████
▓▓▓▓▓▓▓█▓▓█▓▓█▓█▓█▓▓▓████▓██████████████████████████████████████████▓▓▒▒▒▓▓▒▒▓▒▓▓▓▓▒▓▓▓▓▓▓▓▓▓▓▓▓▓▓▓▓▓▓▒▒▒▓▓▓▓▓▓███████▓███████████████████▓▓████▓▓██▓█████████████████████████████████████████▓▓▓▓▓▓▓▓▓▓████████████████████
▓▓▓▓▓▓▓▓▓▓▓▓▓▓▓▓█▓███▓█▓███▓█▓██████████████████████████████████████▓▓▒▒▒▓▓▒▓▓▒▓▓▓▒▒▓▓▓▓▓▓▓▓▓▓▓▓▓▓▓▓▓▓▓▒▓▓▓██▓███▓████▓███████████████████▓▓████▓▓████████████████████████████████████████████▓▓▓▓▓▓▓▓▓▓████████████████████
▓▓▓▓▓▓▓▓▓▓▓█▓▓█▓▓█▓█▓█▓██▓██████████████████████████████████████████▓▓▒▒▒▓▓▒▓▓▓▓▓▓▒▒▓▓▓▓▓▓▓▓▓▓▓▓▓▓▓█▓█▓▓▓████▓████████▓███████████████████▓▓████▓▓██▓█████████████████████████████████████████▓▓▓▓▓▓▓▓▓▓████████████████████
▓▓▓▓▓▓▓▓▓▓▓▓▓█▓█▓▓█▓█▓█▓██▓██▓██████████████████████████████████████▓▓▒▒▒▓▓▒▓▒▓▓▓▓▒▒▓▓▓▓▓▓▓▓▓▓▓▓▓█▓███▓▓▓█▓██▓███▓██▓█▓██▓█▓█████▓████████▓▓████▓▓██▓████████████████████████████████████████▓▓▓▓▓▓▓▓▓▓▓████████████████████
▓▓▓▓▓▓▓▓▓▓▓▓▓▓▓▓█▓▓█▓█▓█▓██▓████▓███████████████████████████████████▓▓▒▒▒▓▓▒▓▒▓▓▓▓▒▒▓▓▓▓▓▓▓▓▓▓▓█▓██▓██▓▓▓████▓█▓██████▓██████▓████████████▓▓▓███▓▓██▓█████████████████████████████████████████▓▓▓▓▓▓▓▓▓▓████████████████████
▓▓▓▓▓▓▓▓▓▓▓▓▓▓▓▓▓█▓▓█▓█▓█▓██▓█▓█████████████████████████████████████▓▓▒▒▒▓▓▒▓▓▒▓▓▓▒▒▓▓▓▓▓▓▓▓▓▓█▓█▓██▓█▓▓▓█▓██▓███▓████▓████▓██████▓█▓█████▓▓███▓▓▓██▓████████████████████████████████████████▓▓▓▓▓▓▓▓▓▓▓████████████████████
▓▓▓▓▓▓▓▓▓▓▓▓▓▓▓▓▓▓█▓▓▓█▓██▓█████▓███████████████████████████████████▓▓▒▒▒▓▓▒▓▓▓▓▓▓▓▒▓▓▓▓▓▓▓▓█▓████▓███▓▓▓████▓████▓███▓█▓████▓█▓██████████▓▓████▓▓██▓████████████████████████████████████████▓▓▓▓▓▓▓▓▓▓▓████████████████████
▓▓▓▓▓▓▓▓▓▓▓▓▓▓▓▓▓▓▓▓█▓▓█▓▓█▓▓█▓██▓█▓████████████████████████████████▓▓▒▒▒▓▓▒▓▓▒▓▓▓▓▓▓▓▓▓▓▓█▓██▓█▓█▓█▓█▓▓▓█▓██▓▓█▓███▓█▓███▓██████▓██▓█████▓▓▓███▓▓██▓████████████████████████████████████████▓▓▓▓▓▓▓▓▓▓▓████████████████████
▓▓▓▓▓▓▓▓▓▓▓▓▓▓▓▓▓▓▓▓▓▓▓▓█▓▓█▓█▓█▓███████████████████████████████████▓▓▒▓▒▓▓▒▓▓▓▓▓▓▓▓▓▓▓▓█▓██▓███▓█████▓▓▓████▓███▓████▓█▓██▓█▓████████▓███▓▓██▓█▓▓██▓████████████████████████████████████████▓▓▓▓▓▓▓▓▓▓▓████████████████████
▓▓▓▓▓▓▓▓▓▓▓▓▓▓▓▓▓▓▓▓▓▓▓▓▓▓█▓▓█▓██▓█▓█▓█▓████████████████████████████▓▓▒▓▓▓▓▒▓▓▓▓▓▓▓▓█▓▓█▓█▓██▓█▓█▓█▓██▓▓▓█▓██▓█▓██▓███▓██▓█████▓█▓█▓██████▓▓▓███▓▓▓█▓████████████████████████████████████████▓▓▓▓▓▓▓▓▓▓▓████████████████████
▓▓▓▓▓▓▓▓▓▓▓▓▓▓▓▓▓▓▓▓▓▓▓▓▓▓▓▓▓▓▓▓▓█▓█████████████████████████████████▓▓▓▓▓▓▓▒▓▓▓▓▓▓▓▓█▓███▓█▓██▓███▓█▓█▓▓▓██▓█▓██▓███▓█▓███▓█▓█████████████▓▓▓██▓▓▓▓▓▓███████████████████████████████████████▓▓▓▓▓▓▓▓▓▓▓▓████████████████████
▓▓▓▓▓▓▓▓▓▓▓▓▓▓▓▓▓▓▓▓▓▓▓▓▓▓▓▓▓▓▓█▓▓█▓█▓█▓█▓██████████████████████████▓▓▓▓▓▓▒▒▓▓▓▓▓▓▓▓█▓█▓██▓█▓██▓█▓████▓▓▓█▓██▓▓██▓████▓█▓█████▓████▓█▓████▓▓▓██▓▒▓▓▓▓███████████████████████████████████████▓▓▓▓▓▓▓▓▓▓▓▓████████████████████
▓▓▓▓▓▓▓▓▓▓▓▓▓▓▓▓▓▓▓▓▓▓▓▓▓▓▓▓▓▓▓▓▓█▓▓█▓█▓████████████████████████████▓▓▓▓▓▓▒▓▓▓▓██▓▓▓▓█▓█▓████▓████▓█▓█▓▓▓██▓█▓████▓███▓███▓█▓███▓█████████▓▓██▓▓▒▓▓▓▓███████████████████████████████████████▓▓▓▓▓▓▓▓▓▓▓▓████████████████████
▓▓▓▓▓▓▓▓▓▓▓▓▓▓▓▓▓▓▓▓▓▓▓▓▓▓▓▓▓▓▓▓▓▓█▓▓█▓█▓█▓█████████████████████████▓▓▓▓▓▓▓▓▓▓▓█▓█▓▓▓▓▓▓▓▓▓▓▓▓▓▓▓▓▓▓▓█▓▓▓█▓██▓█▓█▓██▓█▓▓▓▓▓▓▓▓▓▓▓▓▓▓▓▓▓▓▓▓▓▓▓█▓▓▒▓▓▓▓██████████████████████████████████████▓▓▓▓▓▓▓▓▓▓▓▓▓▓███████████████████
▓▓▓▓▓▓▓▓▓▓▓▓▓▓▓▓▓▓▓▓▓▓▓▓▓▓▓▓▓▓▓▓▓▓▓▓▓▓█▓█▓█▓█▓██████████████████████▓▓▓▓▓▓█▓█▓▓██▓█████████████████████▓▓██▓█▓█████████████████████████████▓███▓▓▓▓▓▓██████████████████████████████████████▓▓▓▓▓▓▓▓▓▒▒▓▓▓███████████████████
▓▓▓▓▓▓▓▓▓▓▓▓▓▓▓▓▓▓▓▓▓▓▓▓▓▓▓▓▓▓▓▓▓▓▓▓▓▓▓▓▓█▓█▓██▓████████████████████▓▓▓▓▓██▓▓█▓▓▓▓▓▓▓▓▓█▓█▓█▓█▓█▓█▓█▓█▓█▓█▓██▓▓█▓█▓█▓█▓█▓█▓█▓█▓█▓█▓▓█▓██████████▓▓▓▓▓█████████████████████████████████████▓▓▓▓▓▓▓▓▒▒▒▒▒▓▓███████████████████
▓▓▓▓▓▓▓▓▓▓▓▓▓▓▓▓▓▓▓▓▓▓▓▓▓▓▓▓▓▓▓▓▓▓▓▓▓▓▓▓▓▓▓▓▓▓▓▓▓▓▓▓▓▓▓▓▓▓██████████▓▓▓▓▓▓█▓█▓█████████▓█▓█▓█▓█▓███▓███████▓█▓███▓█████▓█▓▓▓▓▓▓▓▓▓██▓█████████▓▓▓▓▓▓▓███████████████████████████████████▓▓▓▓▓▓▓▒▒▒▒▒▒▒▒▓▓███████████████████
▒▒▒▒▒▒▒▒▒▒▒▒▒▒▒▒▒▒▒▒▒▒▒▒▒▒▒▒▒▒▒▒▒▒▒▒▒▒▒▒▒▒▒▒▒▒▒▒▒▒▒▒▒▒▒▒▒▒▒▒▓▓▓▓▓▓▓▓▓▓▓▓▓██▓█▓█▓█▓█▓█▓██████████▓███▓█▓█▓█▓██▓█▓██▓█▓▓▓▓▓▓▓▓▓▓████▓████████████▓▓▓▓▓▓▓▓▓▓▓▓▓▓▓▓▓▓▓▓▓▓▓▓▓▓▓▓▓▓▓▓▒▒▒▒▒▒▒▒▒▒▒▒▒▒▒▒▒▒▒▒▒▒▒▒▒▒▓██████████████▓▓▓▓
▒▒▒▒▒▒▒▒▒▒▒▒▒▒▒▒▒▒▒▒▒▒▒▒▒▒▒▒▒▒▒▒▒▒▒▒▒▒▒▒▒▒▒▒▒▒▒▒▒▒▒▒▒▒▒▒▒▓▓▓▓▓▓▓▓▓▓▓▓▓▓▓▓█▓▓█▓█▓█▓█▓██▓█▓█▓█▓█▓███▓████▓███▓█▓██▓██▓█▓▓▓▓▓▓███▓█▓███████████▓█▓▓▓▓▓▓▓▓▓▓▓▓▓▓▓▓▓▓▓▓▓▓▓▓▓▓▓▓▓▓▓▓▓▓▓▒▒▒▒▒▒▒▒▒▒▒▒▒▒▒▒▒▒▒▒▒▒▒▒▒▒▒▒▒▓▒▓▓▓▓▓▓▓▓▒▒▒▒
▒▒▒▒▒▒▒▒▒▒▒▒▒▒▒▒▒▒▒▒▒▒▒▒▒▒▒▒▒▒▒▒▒▒▒▒▒▒▒▒▒▒▒▒▒▒▒▒▒▒▒▒▒▒▒▓▓▓▓▓▓▓▓▓▓▓█▓▓▓▓████▓▓▓▓▓▓▓▓▓▓▓▓▓▓▓▓▓▓▓▓▓▓▓▓▓▓▓▓█▓▓▓▓▓▓▓▓▓▓▓▓▓▓▓▓▓▓▓▓▓▓███████▓█▓█▓█▓█▓▓▓▓▓▓▓▓▓▓▓▓▓▓▓▓▓▓▓▓▓▓▓▓▓▓▓▓▓▓▓▓▒▒▒▒▒▒▒▒▒▒▒▒▒▒▒▒▒▒▒▒▒▒▒▒▒▒▒▒▒▒▓▓▓▓▓▓▓▓▓▓▓▓▓▒▒▒▒
▒▒▒▒▒▒▒▒▒▒▒▒▒▒▒▒▒▒▒▒▒▒▒▒▒▒▒▒▒▒▒▒▒▒▒▒▒▒▒▒▒▒▒▒▒▒▒▒▒▒▒▒▓▓▓▓▓▓▓▓▓███████████████████████████████████████████████████████████████████████████████████████████████▓▓▓▓▓▓▓▓▓▓▓▓▓▓▓▓▓▓▓▓▓▓▓▓▓▓▓▓▓▓▓▓▓▓▒▒▒▒▒▒▒▒▒▒▒▒▒▓▓▓▓▓▒▒▒▒▒▒▒▒▒▒▒▒
▒▒▒▒▒▒▒▒▒▒▒▒▒▒▒▒▒▒▒▒▒▒▒▒▒▒▒▒▒▒▒▒▒▒▒▒▒▒▒▒▒▒▒▒▒▒▒▒▒▒▒▒▒▒▒▒▓▓▓▓▓▓▓▓▓▓▓▓▓▓▓▓▓▓▓▓▓▓█████████████████████████████████████████████████████████████████████████████████▓▓▓▓▓▓██████████████▓▓▓▓▓▓▓▓▓▓▓▓▓▓▓▓▓▓▓▓▓▓▓▓▓▓▓▓▓▓▓▓▓▓▓▓▓▓▓▓▓
▒▒▒▒▒▒▒▒▒▒▒▒▒▒▒▒▒▒▒▒▒▒▒▒▒▒▒▒▒▒▒▒▒▒▒▒▒▒▒▒▒▒▒▒▒▒▒▒▒▒▒▒▒▒▒▒▒▒▓▓▓▓▓▓▓▓▓▓▓▓▓▓▓▓▓▓▓▓▓▓▓▓▓▓▓▓▓▓▓▓▓▓▓▓▓▓▓▓██████████████████████████████████████████████████████████████████████████████████████▓▓▓▓▓▓▓████████████▓▓▓▓▓▓▓▓▓▓▓▓▓▓▓▓▓
