██████▓▓▓▓█▓▒▒▓██▓▓▓▓▓▓▓▓▓▓▓▓▓▓▓▓▓▓▓▓▓▓▓▓█▓█▓██████████████████████████████████████████████████████████████████████████████████████████▓█▓▓▓▓▓▓▓▓▓▓▓▓▓▓▓▓▓▓▓▓▓▓▓▓▓▓▓▓▓▓▓▓▓▒▒▒▒▒▒▒▒▒▒▒▒▒▒▒▒▒▒▒▒▒▒▒▒▒▒▒▒▒▒▒▒▒▒▒▒▒▒▒▒▒▒▒▒▒▒▒▒▒▒
█████████▓▓▓██▓▓██▓▓▓▓▓▓▓▓▓▓▓▓▓▓▓▓▓█▓█▓█▓█▓█████████████████████████████████████████████████████████████████████████████████████████████▓█▓█▓▓▓▓▓▓▓▓▓▓▓▓▓▓▓▓▓▓▓▓▓▓▓▓▓▓▓▓▓▓▓▓▒▓▒▒▒▒▒▒▒▒▒▒▒▒▒▒▒▒▒▒▒▒▒▒▒▒▒▒▒▒▒▒▒▒▒▒▒▒▒▒▒▒▒▒▒▒▒▒
███████████▓▓▓██▒▒▒▓▓▓▓▓▓▓▓▓▓▓▓▓▓▓▓▓█▓█▓█▓█▓██████████████████████████████████████████████████████████████████████████████████████████████▓▓▓▓▓▓▓▓▓▓▓▓▓▓▓▓▓▓▓▓▓▓▓▓▓▓▓▓▓▓▓▓▓▒▓▒▒▒▒▒▒▒▒▒▒▒▒▒▒▒▒▒▒▒▒▒▒▒▒▒▒▒▒▒▒▒▒▒▒▒▒▒▓▒▒▒▒▒▒▒▒▒
██████████████▓▓█▓▒▒▓▓▓▓▓▓▓▓▓▓▓▓▓▓▓▓▓▓▓▓▓▓▓▓▓▓▓▓▓▓▓▓▓▓▓▓▓▓▓▓▓▓▓▓▓▓▓▓▓▓▓▓▓▓▓▓▓▓▓▓▓▓▓▓▓▓▓▓▓▓▓▓▓▓▓▓▓▓▓▓▓▓▓▓▓▓▓▓▓▓▓▓▓▓▓▓▓▓▓▓▓▓▓▓▓▓▓▓▓▓▓▓▓▓▓▓▓▓▓▓▓▓▓▓▓▓▓▒▓▒▒▒▒▒▒▒▒▒▒▒▒▒▒▒▒▒▒▒▒▒▒▒▒▒▒▒▒▒▒▒▒▒▒▒▒▒▒▒▒▒▒▒▒▒▒▒▓▓▒▒▒▒▒▒▒▒▒▓▓▒▒▒▒▒▒▒▒▒▒▒
████████████████▓▓▓▓█▓███████████████████████████████████████████████████████████████████████████████████████████████████████████████████████▓▓▓▓▓▓▓▓▓▓▓▓▓▓▓▓▓▓▓▓▓▓▓▓▓▓▓▓▓▓▓▓▓▓▒▓▒▒▒▒▒▒▒▒▒▒▒▒▒▒▒▒▓▓▓▓▓▒▒▒▒▒▒▒▒▒▒▒▒▒▒▒▒▒▒░░░▓
██████████████████▓▓▓█▓▓▓█▓████████████████████████████████████████████████████████████████████████████████████████████████████████████████▓▓█▓▓▓▓▓▓▓▓▓▓▓▓▓▓▓▓▓▓▓▓▓▓▓▓▓▓▓▓▓▓▓▒▒▒▒▒▒▒▒▒▒▒▒▒▒▒▒▒▒▓▓▓▓▓▓▓▒▒▒▒▒▒▒▒▒▒▒▒▒▒▒░▒░██▓█
██████████████████▓██████████████████████████████████████████████████████████████████████████████████████████████████████████████████████████████████████▓█▓▓▓▓▓▓▓▓▓▓▓▓▓▓▓▓▓▓▓▓▓▓▓▓▓▓▓▓▓▓▓▓▓▒▒▓▓▓▓▓▓▓▓▒▒▒▒▒▓▒▒▒▒▒░▒▓▓█▒▒██▓█
██████████████████▓███████████████████████████████████████████████████████████████████████████████████████████████████████████████████████████████████████▓▓▓▓▓▓▓▓▓▓▓▓▓▓▓▓▓▓▓▓▓▓▓▓▓▓▓▓▓▓▓▓▓▓▒▒▓▓▓▓▓▓▓▓▒▒▒▒▓▓▓▒▒▒▓█████▓▒██▓█
██████████████████▓█████████████████████████████████████████████████████████████████████████████████████████████████████████████████████████████████████████▓▓▓▓▓▓▓▓▓▓▓▓▓▓▓▓▓▓▓▓▓▓▓▓▓▓▓▓▓▓▓▓▒▒▓▓▓▓▓▓▓▓▒▒▓▓████▓███████▓▒██▓█
██████████████████▓███████████████████████████████████████████████████████████████████████████████████████████████████████████████████████████████████████████▓▓▓▓▓▓▓▓▓▓▓▓▓▓▓▓▓▓▓▓▓▓▓▓▓▓▓▓▓▓▒▒▓▓▓▓▓▓▓▓▒▒▓▓████▓███████▓▒██▓█
██████████████████▓████████████████████████████████████████████████████████████████████████████████████████████████████████████████████████████████████████████▓█▓▓▓▓▓▓▓▓▓▓▓▓▓▓▓▓▓▓▓▓▓▓▓▓▓▓▓▓▒▓▓▓▓▓▓▓▓▒▒▓▓████▓███████▓▒██▓█
██████████████████▓█████████████████████████████████████████████████████████████████████████████████████████████████████████████████████████████████████████████▓▓▓▓▓▓▓▓▓▓▓▓▓▓▓▓▓▓▓▓▓▓▓▓▓▓▓▓▓▒▓▓▓▓▓▓▓▓▒▒▓▓████▓███████▓▒██▒█
██████████████████▓████████████████████████████████████████████████████████████████████████████████████████████████████████████████████████████████████████████████▓▓▓▓▓▓▓▓▓▓▓▓▓▓▓▓▓▓▓▓▓▓▓▓▓▓▒▓▓▓▓▓▓▓▓▒▒▓▓████▓███████▒░▒▒▒█
██████████████████▓█████████████████████████████████████████████████████████████████████████████████████████████████████████████████████████████████████████████████▓▓▓▓▓▓▓▓▓▓▓▓▓▓▓▓▓▓▓▓▓▓▓▓▓▓▓▓▓▓▓▓▓▓▒▒▓▓████▓██▓▒▒▒▒▒▒██▓█
██████████████████▓███████████████████████████████████████████████████████████████████████████████████████████████████████████████████████████████████████████████▓▒▓▒▒▓▓▓▓▓▓▓▓▓▓▓▓▓▓▓▓▓▓▓▓▓▓▓▓▓▓▓▓▓▓▓▒▒▓▓████▒▒▒▓████▓▒██▓█
██████████████████▓█████████████████████████████████████████████████▓▒▒▒▓▒▓▒▓▒▓▓▓▓▓▓▒▓▒▓▓▓▓▓▓▓▓▓▓▓▓▒▓▒▒▓▒▓▓████████████████████████████████████████████████████▓▒▒▒▒▒▒▒▓▓▓▓▓▓▓▓▓▓▓▓▓▓▓▓▓▓▓▓▓▓▓▓▓▓▓▓▓▓▓▒▒▓▓████▓███████▓▒██▓█
██████████████████▓████▓▓▓▓▓▓▓▓▓▓▓▓▓▓█▓█▓▓▓▓███▓▓▓▓▓▓▓▓▓▓▓▒▓██████▓▓▓▒▓█▓▓▓▓▓▓▓▓▓▓▓▓▓▓▓▓▓▓▓▓▓▓▓▓▓▓▓▓▓▓▓█▓▓▓█████████████████████████████████████████████████████▓▓▒▒▒▒▒▓▓▓▓▓▓▓▓▓▓▓▓▓▓▓▓▓▓▓▓▓▓▓▓▓▓▓▓▓▓▓▒▒▓▓████▓███████▓▒██▓█
██████████████████▓███▓▓▓▓▓▓▓▓▓▓▓▓▓▓▓▓▓▓▓▒▒▓███▓▓█████████▒▓██████▓▓▓▒▓█▓▓▒▒▒▒▒▒▒▒▒▒▒▒▒▒▒▒▒▒▒▒▒▒▒▒▒▒▒▒░▓▓▓▓███████████████████████████████████████████████████▓▒▓█▓▒█▓▓▓▓▓▓▓▓▓▓▓▓▓▓▓▓▓▓▓▓▓▓▓▓▓▓▓▓▓▓▓▓▓▒▓▓▓████▓███████▓▒██▓█
██████████████████▓███▓▓█████████████████▒▒▓███▓▓█████████▒▓██████▓▓▓▒▓█▓█▒▓▓▓▓▓▓▓▓▓▓▓▓▓▓▓▓▓▓▓▓▓▓▓▓▓▓▒░▓▓▓▓███████████████████████████████████████████████▓▓▓▓▒▒▓█▓▒█▓█▓█▒██████▓█▓▓▓▓▓▓▓▓▓▓▓▓▓▓▓█▓█▓▓▒▓▓▓████▓███████▓▒██▓█
██████████████████▓███▓▓█████████████████▒▒▓██▓▓▓█████████▒▓██████▓▓▓▒▓█▓█▓██▓▓▓▓▓▓▓▓▓▓▓▓▓▓▓▓▓▓▓▓▓▓▓▓▓▒▓▓▓▓███████████████████████████████████████████████▓▓▓▓▒▒▓█▓▓█▓█▓█▒███████▓███▓█▓▓▓▓▓▓▓████████▒▓▓▓████▓███████▓▒██▒█
██████████████████▓███▓▓█████████████████▒▒▓██▓▓▓█████████▒▓██████▓▓▓▒▓█▓█▓██▓▒▒▒▒▒▒▒▒▒▒▒▒▒▒▒▒▒▒▒▒▒▒▓▓▒▓▓▓▓███████████████████████▓█▓▓▓▓▓▓▓▓▓▓▓▓▓▓▓▓▓▓▓▓▒▒▒▒▒▒▒▒▒▓▒▒▓▓▓▓▓▒▓▓▓▓█████████████▓▓▓████████▒▓▓▓████▓██████▒▒▒▒▒▒█
██████████████████████▓▓█████████████████▒▒▓██▓▓▓█████████▒▓██████▓▓▓▒▓█▓█▓██▓▓█████████████████▓▓▒▒▓▓▒▓▓▓▓██████████████████████▒▓▓▓▓▓▓▓▓▓▓▓▓▓▓▓▓▓▓▓▓▓▓▓▓▓▓▓▓▓▓▓▓▓▓▓▓▓▓▓▓▓▒█▓██████████████▓▓████████▒▓▓▓████▓▓▒▒▒▒▒▓▒▒██▓█
██████████████████▓███▓▓█████████████████▓▒▓███▒▒▒▒▒▒▒▒▒▒▒▒▓██████▓▓▓▒▓███▓██▓▓██████████████████▓▒▒▓▓▒▓▓▓▓█████████████████████▒▒▓▓▒▒▒▒▒▒▒▒▒▒▒▒▒▒▒▒▒▒▒▒▒▒▒▒▒▒▒▒▒░░░▒▒▒▒▒▒█▓█▓██████████████▓▓████████▓▓▓▓███▓▒▓██████▓▒██▓█
██████████████████▓███▓▓█████████████████▒▒▓██████████████████████▓▓▓▒▓███▓██▓▓██████████████████▓▒▒▓▓▒▓▓▓▓█████████████████▓▓▓▒▒▒█▓▒▒▓▓▓▒▓▓▓▓▓▓▓▓▓▓▓▓▒▒▒▒▒▒▒▒▒▒▒▒▒▒▒▒▒▒▒▒█▓█▓██████████████▓▓████████▓▓▓▓████▓███████▓▒██▓█
██████████████████████▓▓█████████████████▓▒▓███▓▓▓▓▓▓▓▓███████████▓▓▓▒▓███▓██▓▓██████████████████▓▒▒▓▓▒▓▓▓▓██████████████▓▓▓▓▓▓▓▒▒▓▓▓▓██▓▓▓▒▓▓▓▓▓▓▓▓▓▓▒▓▓▓▓▒▒▒▒▒▒▒▓▓▒▒▒▒▒▒█▓█▓██████████████▓▓████████▓▓▓▓████▓███████▓▒██▓█
██████████████████▓███▓▓█████████████████▒▒▓██▓▓▓▓▓▓▓▓▒███████████▓▓▓▒▓██████▓▓██████████████████▓▒▒▓▓▒▓▓▓▓███████████▓▓▓▓▓▓▓▓▓▓▒▒█▓▓▓██▓▓▒▒▓▓▓▓▓▓▓▓▓▓▒▓▓▓▒▒▒▒▒▒▒▓████░▒▒▒█▓█▓██████████████▓▓████████▓▓▓▓████▓███████▓▒██▓█
██████████████████▓███▓▓█████████████████▒▒▓██▓▓▓▓▓▓▓▓▓███████████▓▓▓▒▓██████▓▓██████████████████▓▒▒▓▓▒▓▓▓▓██████████▓▓▓▓▓▓▓▓▓▓▓▒▒▓▓▒▓▓▓▓▒▒▓▓▓▒▒▓▓▓▓▒▒▒▓█▓▒▒▒▒▒▒▒▓███▒▒▒▒▒█▓█▓███████████████▓████████▓▓▓▓████▓███████▓▒██▓█
██████████████████▓███▓▒▓▓▓▓▓▓▓▓▓▓▓▓▓▓▓▓▓▓▒▒██████████████████████▓▓▓▒▓██████▓▓██████████████████▓▒▒▓▓▒▓▓▓▓██████████▓▓▓▓▓▓▓▓▓▓▓▒▒█▓▓▓▓▓▓▓▓▓▓▓▓▓▓▓▓▓▓▓▓▓▓▓▓▓▓▓▓▓▓▓▓▓▓▓▓▓▓▓█▓█▓███████████████▓████████▓▓▓▓████▓███████▓▒██▒█
█████████████████████████▓█▓█▓██████▓█▓████████████▓▓▓▓▓▓▓▓▓▓▓▓███▓▓▓▒▓██████▓▓██████████████████▓▒▒▓▓▒▓▓▓▓█████████▓█▓▓▓▓▓▓▓▓▓▓▒▒█▓▒▒▒▒▒▒▒▒▒▒▒▒▒▒▒▒░▒▒░▒▒▒▒▒▒▒▒▒▒▒▒▒▒░▒▒▒█▓█▓███████████████▓████████▓▓▓▓████▓███▓▒▒▒▒░▒▒▒█
██████████████████▓███████████████████████████████▓▓██████████▓▓██▓▓▓▒███████▓▓██████████████████▓▒▒▓▓▒▓▓▓▓████████▓▓▓▓▓▓▓▓▓▓▓▓▓▒▒▓▓▒▒▒▒▒▒▒▒▒▒▒▒▒▒▒▒▒▒▒▒▒▒▒▒▒▒▒▒▒▒▒▒▒▒▒▒▒▒█▓█▓████████████████████████▓▓▓▓████▒▒▒▓▓███▒▒██▓█
██████████████████████▓▒▓▓▓▓▓▓▓▓▓▓▒▒████▓▓▓▓▓▓▓▒▓█▓▓██████████▓▓███▓▓▒▓██████▓▓██████████████████▓▒▒▓▓▒▓▓▓▓██████▒▒▓█████▓▓▓▓▓▓▒▒▒█▓▓▓▓▒▓▓▓▓▓▓▓▒▒▒▓▓▒▒▒█▓███▓▒▒▒▓▒▒▒▒▒▒▒▒▒█▓█▓████████████████████████▓▓▓▓████▓███████▓▒██▓█
██████████████████████▓▓▓████████▓▒▒████▓██████▒▓█▓▓██████████▓▓███▓▓▒▓██████▓▓██████████████████▓▒▒▓▓▒▓▓▓▓████▓▓▒▓▓██████▒▓▓▓▓▒▒▒▓▓▒▒▓▓▓▓▓▓▒▒▒▒▒▒▓▓▒▒▒█▓████▓▓▒█▓▒▓▒▒▒▒▒▒█▓██████████████████████████▓▓▓▓████▓███████▓▒██▓█
██████████████████▓███▓▓██████████▒▒████▓▒▓▓▓▓▓▒▓█▓▓██████████▓▓██▓▓▓▒▓██████▓▓██████████████████▓▒▒▓▓▒▓▓▓▓█▓▓▓▓▒▓▓▓██████▓▓▓▓▓▒▒▒█▓▒▒▓██▓█▓▓▓▓▒▒▒▓▓▒▒▒█▓████▓█▓█▓▓▓▒▒▒▒▒▒█▓██████████████████████████▓▓▓▓████▓███████▓▒██▓█
██████████████████████▓▓██████████▒▒██████████████▓▓██████████▓▓███▓▓▒▓██████▓▓██████████████████▓▒▒▓▓▒▓▓▓▒▓▓▓▓▒▒▓▓▓███████▒▓▓▓▒▒▒▓▓▒▒▒▓▓▓▓▓▓▓▓▒░▒▓▓▒▒▒▓▓▓▓█▓▓▓▒█▓▒▒▒▒▒▒▒▒█▓██████████████████████████▓▓▓▓████▓███████▓▒██▓█
██████████████████▓███▓▓██████████▒▒██████████████▓▓██████████▓▓███▓▓▒▓███▓██▓▓█████████████████▓▓▒▒▓▓▒▓▒▓▒▓▓▓▓▒▒▓▓▓█▓█████▒▓▓▓▒▒▒█▓▒▒▒▒▒▒▒▒▒▒▒▒▒▒▒▒▒▓▒▒▒▒▒▒▒▒▒▒▒▒▒▒▒▒▒▓▓▒█▓██████████████████████████▓▓▓▓████▓███████▓▒██▓█
██████████████████████▓▓██████████▒▒██████████████▓▓██████████▓▓███▓▓▒▓██████▓▓█████████████████▓▓▒▒▒▒▒▓▒▓▒▓▓▓▓▒▒▒▒▒▒▒▒▒▒▒▒▒▓▓▓▒▒▒█▓▒▒▒▒▒▒▒▒▒▒▒▒▒▒▓▒▒▒▒▒▓▒▒▒▒▒▒▒▒▒▒▒▒▒▒▒▒▒█▓██████████████████████████▓▓▓▓████▓███████▓▒▓█▓█
██████████████████▓███▓▒██████████▒▒██████████████▓▒▓▓▓▓▓▓▓▓▓▓▓████▓▓▒▓███▓██▓▓████████████████▓▓▒▒▒▒▒░▓▒▓▒▓▓▓▓▓▓▓▓▓▒▒▒▓▓▓▓▓▓▓▓▒▒▒█▓▒▓▓▒▒▒▒▒▒▒▓█▓▓██▒▒▒▓█▓█▓▓▓▒▒▒▒▒▒▒▒▒▒▓▒█▓██████████████████████████▓▓▓▓████▒▒▒▒▒▒▒▒▒▒▒▒▒█
██████████████████████▓▒▓████████▓▒▒███████████████████████████████▓▓▒▓███▓██▓▓█████████████▓▓▓▓▓▒▒▒▒▒░▓▒▓▒▓▓▓▓▓▓▓▓▓▒▓▒▓▓▓▓▓▓▓▓▓▒▒█▓▒▓██▓▓▓▒▒███▓▓██▒▒▒▓███▓█▓▓▒▒▒▓▒▒▒▒▒▒▒█▓██████████████████████████▓▓▓▓████▓███████▒▒██▓█
██████████████████▓█████▓▓███▓▓██▓██████████████████████████████████▓▒▓███▓██▓▒▒▒▒▒▒▒▒▒▒▒▒▒▒▒▒▒▒▒░░▒▒▒░▓▒▓▒▓▓▓▓▓▓▓▓▓▓▓▒▓▓▓▓▓▓▓▓▓▒▒█▓▒▓██▓██▓▓███▓▓██▒▒▒▓███▓█▓▓█▒▒█▒▒▒▒▒▓▒█▓██████████████████████████▓▓▓▓████▓███████▓▒██▓█
███████████████████████████████████████████████████████████████████▓▓▒▓███▓██████████████████▓▓▓▓▓▓▓▓▓▒▓▒▓▒▓▓▓▓▓▓▓▓▓▓▓▒▓▓▓▓▓▓▓▓▓▒▒█▓▒▓▓▓▓▓▓▓▓▓▓▓▓▓▓▓▒▒▒▓▓▓▓▓▓▓▒▓▓▓▓▓▓▒▒▒▒▒█▓██████████████████████████▓▓▓▓████▓███████▓▒██▓█
██████████████████▓████████████████████████████████████████████████▓▓▒▓█▓█▓██▓▓▓▓▓▓▓▓▓▓▓▓▓▓▒▒▒▒▒▒▒▒▒▓▓▒▓▒▓▒▓▓▓▓▓▓▓▓▓▓▓▓▓▓▓▓▓▓▓▓▒▒▒█▓▒▒▒▒▒▒▒▒▒▒▒▒▒▒▒▒▒▒▒▒▒▒▒▒▒▒▒▒▒▒▒▒▒▒▒▒▒▒█▓██████████████████████████▓▓▓▓████▓███████▓▒██▓█
███████████████████████████████▓▓████████████████▓▓█████████████████▓▒▓███▓██▓▓▓██████████▓▓▓▓▓▓▓▒▒▒▓▓▒▓▒▓▒▓▓▓▓▓▓▓▓▓▓▓▓▓▓▓▓▓▓▓▓▒▒▒█▓▒▒▒▒▒▒▒▒▒▒▒▒▒▒▒▒▒▒▒▒▒▒▒▒▒▒▒▒▒▒▒▒▒▒▒▒▒▒█▓██████████████████████████▓▓▓▓████▓███████▓▒██▓█
██████████████████▓█████████▓▒▓█████████████████████▓███████████████▓▒▓███▓█████████████████▓▓▓▓▓▓▓▓▓▓▒▓▒▓▒▓▓▓▓▓▓▓▓▓▓▓▓▓▓▓▓▓▓▓▓▒▒▒█▓▓▓▓▓▓▓▓▒▒▒▒▓▒▒▓▓▒▒▒▓▒▒▒▒▒▒▒▒▒▒▒▒░▒▒▒▓▒█▓██████████████████████████▓▓▓▓████▓███████▓▒██▓█
██████████████████████████▓▒▒▒███████████████████████▓██████████████▓▒▓███▓██▓▓▓▓▓▓▓▓▓▓▓▓▓▓▓▒▒▒▒▒▒▒▒▓▓▒▓▒▓▒▒▓▓▓▓▓▓▓▓▓▓▓▓▓▓▓▓▓▓▓▒▒▒██▓▓▓█████▓▒▒█▓▓██▒▒▒▓▓▓▓▒▒▒▒▒▒▒▒▒▒▒▒▒▓▒█▓██████████████████████████▓▓▓▓████▓▓▓▓▓▓▓▓▒▒▓▓▒▓
██████████████████▓██████▓▒▒▒▒███████████████████████▒▓▓▓▓██████████▓▒▓███▓██▓▓█████████████▓▓▓▓▓▒▒▒▓▓▒▓▒▓▒▒▓▓▓▓▓▓▓▓▓▓▓▓▓▓▓▓▓▓▓▒▒▒██▓▓▓██████▓▓█▓▓██▓▒▒▓███▒▒▒▒████▒▒▒▒▒▓▒█▓██████████████████████████▓▓▓▓██▓▓▓▓▓▓▓▓▓▓▓▓▓▓▓▓
██████████████████▓█████▒▒███▓▓██████████████████████▒▒▒▒▓▓▓▓▒▓█████▓▒▓███▓██▓▓████████████████▓▓▓▒▒▓▓▒▓▒▓▒▒▓▓▓▓▓▓▓▓▓▓▓▓▓▓▓▓▓▓▓▒▒▒██▒▓▒▓▓▓▓▓▓▒▒▓▒▓▓▓▒▒▒▓▓▓▒▒▒▒▒▓██▓▒▒▒▒▒▒▒█▓██████████████████████▓▓▓▓▓▓▓▓▓▓▓▓▓▓▓▓▓▓▓▒▒▒▒▒▒▒
██████████████████▓████▓▒▒▓███▓███████████████████▓▓▒▒▓▓▒█▓███▓█████▓▒▓███▓██▓▓████████████████▓▓▓▒▒▓▓▒▓▒▓▒▒▓▓▓▓▓▓▓▓▓▓▓▓▓▓▒▓▓▓▓▒▒▒██▓▓▓▓▓▓▓▓▓▓▓▓▓▓▓▓▓▒▓▒▓▓▓▓▓▓▓▓▓▓▓▓▓▓▓▓▒▒█▓██████████████████████████▓▓▓▓▓▒▒▒▒▒▒▒▒▒▒▒▒▒▒▒▒▒
██████████████████▓█▓▓▒▒▒▒▓███▓████████████████▓▓▓▓▓▒▒▓▒▒█▓███▓████▓▓▒▓███▓██▓▓████████████████▓▓▓▒▒▓▓▒▓▒▓▒▒▓▓▓▓▓▓▓▓▓▓▓▓▓▓▒▓▓▓▓▒▒▒██████████████████▓▓█████████████████▓▒▒█▓███████████████████████████▓█▓▓▓▓▓▓▓▓▓▓▓▓▓▒▓▓▓▒▓
███▓█▓████████▓█▓▒▒▓▓▒▒▒▒▒▓███▓▓█▓█▓████████▓▓▓▓▓▓▓▒▒▒▒▒▒█▓███▓████▓▓▒▓███▓██▓▓█████████████████▓▓▒▒▓▓▒▓▒▓▒▒▓▓▓▓▓▓▓▓▓▓▓▓▓▓▒▓▓▓▓▒▒▒█████████▓▓▓██████▓▓█████████▓▒▓█████▓▒▒█▓█████████████████▓████████▓██▓▓█▓▓▓▓▓▓▓▓▓▓▒▓▓▓▒▓
▓▓▓▒▓▒████▓█▓▓▒▓▓▒▒▓▒▒▒▒▒▒▓███▓▒▓█████████████████████▓▒▒█▓███▓████▓▓▒▓███▓██▓▓█████████████████▓▓▒▒▓▓▒▓▒▓▒▒▓▓▓▓▓▓▓▓▓▓▓▓▓▓▒▓▓▓▒▒▒▒███████▓▓▓▓▓██████▓▓███████▓▓▓▓▓█████▓▒▒█▓██████████████▓█▓▓█▓█▓██▓█▓▓█▓▓█▓▓▓▓▓▓▓▓▓▓▒▓▓▓▒▓
▒▓▓▒▓▒▓█▓█▓█▓▓▒▓▓▒▒▒▒▒▒▒▒▒▓███▓▒███████████████████████▒▒█▓███▓████▓▓▒▓█▓█▓██▓▓█████████████████▓▓▒▒▓▓▒▓▒▓▒▒▓▓▓▓▓▓▓▓▓▓▓▓▓▓▒▓▓▓▒▒▒▒███████████████████▓█████████████████▓▓▒█▓█████████████▓▓█▓▓█▓▓▓██▓█▓▓█▓▓▓▓▓▓▓▓▓▓▓▓▓▒▓▓▓▒▓
▒▓▓▒▓▒▓█▓█▓█▒▒▒▓▒▒▒▒▒▒▒▒▒▒▓███▒▒▓█████████████████████▓▒▒█▓███▓████▓▓▒▓███▓██▓▓█████████████████▓▓▒▒▓▓▒▓▒▓▒▒▓▓▓▓▓▓▓▓▓▓▓▓▓▓▒▓▓▓▒▒▒▒██████████████████▓▓█████████████████▓▒▒█▓█████████▓███▓▓█▓▓█▓▓▓▓█▓█▓▓█▓▓▓▓▓▓▓▓▓▓▓▓▓▒▓▓▓▒▓
▒▓▓▒▓▒▓█▓█▓█▒▒▒▒▒▒▒▒▒▒▒▒▒▒▓███▓▒▒▒▒▒▒▒▒▒▒▒▒▒▒▓▓▒▓▓▓▓▓▓▓▒▒█▓███▓████▓▓▒▓█▓█▓██▓▓███████████████▓█▓▓▒▒▓▓▒▓▒▓▒▒▓▓▓▓▓▓▓▓▓▓▒▓▓▓▒▓▓▓▒▒▒▒██████████████████▓▓██████████▓██████▓▒▒█▓████████▓▓███▓▓█▓▓▓▓▓▓▓█▓▓▓▓█▓▓▓▓▓▓▓▓▓▓▓▓▓▒▓▓▓▒▓
▒▒▒▒▒▒▓█▓█▓█▒▒▒▒▒▒▒▒▒▒▒▒▒▒▓███▓▓████████████████████████▒█▓███▓████▓▓▒▓███▓██▓▒▒▒▒▒▒▒▒▒▒▒▒▒▒▒▒▒▒▒▒▒▒▓▓▒▓▒▓▒▒▓▓▓▓▓▓▓▓▒▓▒▓▓▓▒▓▓▓▒▒▒▒█████████▓▒▓██████▓▓████████▓▓▒▓█████▓▒▒█▓████▓▓██▓▓▓▓▓▓▓▓▓▓▓▓▓▓▓▓▓▓▓▓▓▓▓▓▓▓▓▓▓▓▓▓▓▓▒▓▓▓▒▓
▒▒▒▒▒▒▓█▓█▓█▒▒▒▒▒▒▒▒▒▒▒▒▒▒▓███▓▓████████████████████████▒▓▓███▓████▓▓▒▓█▓█▓█████████████████▓▓▓▓▓▓▓▓▓▓▒▓▒▓▒▒▓▓▓▒▓▓▓▓▒▓▒▓▓▓▒▓▓▒▒▒▒▒████▓█▓▓▒▓▓▓▓▓▓▓▓█▓▓███▓▓▓▓▓▒▓▓▓▓▓▓▓█▓▒▒█▓█▓▓▓▓▓▓▓▓▓▓▓▓▓▓▓▓▓▓▓▓▓▓▓▓▓▓▓▓▓▓▓▓▓▓▓▓▓▓▓▓▓▒▓▓▓▒▓
▒▒▒▒▒▒██▓▓▒▒░░░▒▒░░░░░░░░░░░░▒▒░░░░░░░░░░░░░░░░░░░░▒▒▒▒▒▒▒▒▒▓▓▓▓▓▓▓▓▒▒▓███▓██████████████████████▓▓▓▓▓▒▓▒▓▒▒▒▒▒▒▒▒▒▒▒▓▒▒▒▒▒▒▒▒▒▒▒▒██▓▓▓▓▓▓▓▓▓▓▓▓▓▓▓▓▓▓█▓▓▓▓▓▓▓▓▓▓▓▓▓▓▓▓▒▒▒▓▓▓▒▒▒▒▒▒▒▒▒▒▒▒▒▒▒▒▒▒▒▒▒▒▒▓▓▓▓▓▓▓▓▓▓▓▓▓▓▓▓▓▓▒▓▓▓▒▓
▒▒▒▒▒▒▒▒▒▒▒▒▒▒▒▒▒▒▒▒▒▒▒▒▒▒▒▒▒▒▒▒▒▒▒▒▒▒▒▒▒▒▒▒▒▒▒▒▒▒▓█████▒█▓██████████▒▓█▓█▓█████████████████████▓█▓▓▓▓▒▓▒▓▒▒▓▓▓▓▓▓▓▒▒▓▒▓▓▓▓▓▓▒▒▒▒▒▓██████████████████████████████████▓▓▓▓▒▒▒▓▒▓▓▓▓▓▓▓▓▓▓▓▓▓▓▒▒▓▓▓▓▓▒▒▒▒▒▒▒▒▒▒▓▓▒▓▓▒▓▓▓▒▓▓▓▒▒
▒▒▒▒▒▒▒▒▒▒▒▒▒░░░░░░░░░░░▒░░░▒▓▓░░░░░░░░░░░▒▒▒░▒▒▓▓█▓▓███▒█▓▓████▓████▓████▓███▓██████▓████▓█████▓█████▓▓▓█▓▓▓▓▓▒▓▒▒▒▒▓▒▒▒▒▒▒▒▒▒▒▒▒▒▓▒▒▒▒▒▒▒▒▒▒▒▒▒▒▒▒▒▒▒▒▒▒▒▒▒▒▒▒▒▒▒▒▒▒▒▒▒▒▓▒▒▒▓▓▓▒▒▒▒▒▒▒▒▒▒▒▒▒▒▒▒▒▒▒▒▓▓▓▓▓▒▒▒▒▒▒▒▒▒▒▒▒▒▒▓▓▒▒
▓▓▒▒▒▒▒▒░░▒▒▒▒▒▒▒▒▒▒▒▒▒▒▒▒▒▒▒▓▓░▒▒▒▒▒▒▒▒▒▒▒▒▒▒▒▒▒▓██████▒█▓█████████████████████████████████████▓██████████████▓▒▒▒▓▓▓▓▓▓▓▓█████▒▓████████████████▓▓▓█████████████████████▓▓██████████▓▓▓▓▓▓▓▓▒▒▓▓▒▒▒▒▒▒▒▒▒▒▓▓▓▒▒▒▒▒▒▒▒▒▒▒▒▒
▓▓▓▓▓▓▒▒▒▒▒▒▒▒▒▒▒▒▒▒▒▒▒▒▒▒▒▒▒▒▓▓▓███▓▓▓███████████▓▓▓▓██▓▓▒▓████████████████████████████████████▓██████▓████████▓████████████████▓▓██████████████████▓▓████████████████████████████████████▓▓▓▓▓▓▓▓▓▓▒▒▒▒▒▒▒▒▒▒▒▒▒▒▒▒▒▒▒▒▒▒▒
███████████████████████████████████████████████████████▓▓▓█████████████████████████████████████████████▓██████▓████████████████████▓▓███████████████████▓▓█████▓████████████████████████████████▓▓▓▓▓▓▓▒▓▓▓▒▒▒▒▒▒▒▒▒▒▒▒▒▒▒▒▒
█████▓▓██████████████████████████████████████▓███████▓▓████████████████████████████████████████████████▓███████▓████████████████████▓▓█████████████████████▓▓█████▓▓██████▓██████▓████████████████████▓▓▓▓▓▓▒▒▒▒▒▒▒▒▒▒▒▒▒▒▒▒
▓▓█████▓▓██████▓▓███████▓▓███████▓███████▓████████▓▓███████▓███████████▓███████████████████████▓███████▓██████████▓███████████████████▓▓█████████████▓███████▓▓▓█████▓▒██████▓▓██████▓▓██████▓███████▓█████▓▒▒▒▓▒▒▒▒▒▒▒▒▒▒▒▒
█▓▓▓██████▓▓████████▓████████▓████████▓████████▓▓▓███████▓██████▓██████████████████████████████████████▓████████▓█▓█▓███████████████████▓███████████████▓███████▓▓██████▓▓▓██████▓▓███████▓███████▓▓██████▓▓████▓▒▒▒▒▒▒▒▒▒▒▒
█████▓▓████████▓▓████████▓████████▓█████████▓█▓█████████████████████▓██████████████████████████████████████████████▓█▓███████████████████▓████████████████▓▓███████▓▓██████▓▓▓████████▓███████▓▓███████▓███████▓▓████▓▓▒▒▒▒▒
▓▓████████▓▓█████████▓█████████▓███████████▓████████████████████████████████▓█████████████████▓█████████▓██████████▓██████████████████████▓▓█████████████████▓▓██████▓█████████▓▓▓████████▓████████▓███████▓▓███████▓▓▓████▓
██████▓▓█████████▓███████████████████████▓█████████▓█████████████▓█████████▓██████████████████▓█████████▓█████████▓█▓███████████████████████▓██████████████████▓▓███████▓█████████▓▓███████████████████▓████████▓▓███████▓▓▓
█▓▓▓▓███████▓▓▓▓████████▓▓██████████▓▓▓▓████████▓▓▓██████▓█████▓▓█████████▓█████████▓█████████▓█████████▓███████████▓██▓█████████▓███████████▓▓████████▓▓████████▓▓▓██████▓█▓▓██████▓▓▓▓████████▓▓███████▓▓▓██████▓▓▓▓▓█████