░░░░░░▒▒▒▒░▒▒▒▒░░▒▒▒▒▒▒▒▒▒▒▒▒▒▒▒▒▒▒▒▒▒▒▒▒░▒░▒░░░░░░░░░░░░░░░░░░░░░░░░░░░░░░░░░░░░░░░░░░░░░░░░░░░░░░░░░░░░░░░░░░░░░░░░░░░░░░░░░░░░░░░░░░▒░▒▒▒▒▒▒▒▒▒▒▒▒▒▒▒▒▒▒▒▒▒▒▒▒▒▒▒▒▒▒▒▒▒▒▒▒▒▒▒▒▒▒▒▒▒▒▒▓▒▓▓▓▓▒▓▒▓▓▓▓▓▓▓▓▓▓▓▒▒▓▓▓▓▓▓▓▓▓▒▒▒▒▓
░░░░░░░░░▒▒▒░░▒▒░░▒▒▒▒▒▒▒▒▒▒▒▒▒▒▒▒▒▒▒▒░▒░▒░▒░░░░░░░░░░░░░░░░░░░░░░░░░░░░░░░░░░░░░░░░░░░░░░░░░░░░░░░░░░░░░░░░░░░░░░░░░░░░░░░░░░░░░░░░░░░░▒░▒▒▒▒▒▒▒▒▒▒▒▒▒▒▒▒▒▒▒▒▒▒▒▒▒▒▒▒▒▒▒▒▒▒▒▒▒▒▒▒▒▒▒▒▒▒▒▒▓▓▓▓▒▒▓▓▓▓▒▒▓▓▓▒▒▒▓▓▓▓▓▓▓▓▒▒▒▒▓▓▓▓
░░░░░░░░░░░▒▒▒░░▒▒▒▒▒▒▒▒▒▒▒▒▒▒▒▒▒▒▒▒░▒▒░▒░▒░░░░░░░░░░░░░░░░░░░░░░░░░░░░░░░░░░░░░░░░░░░░░░░░░░░░░░░░░░░░░░░░░░░░░░░░░░░░░░░░░░░░░░░░░░░░░░▒░▒▒▒▒▒▒▒▒▒▒▒▒▒▒▒▒▒▒▒▒▒▒▒▒▒▒▒▒▒▒▒▒▒▒▒▒▒▒▒▒▒▒▒▒▒▒▓▒▓▓▓▓▓▓▒▒▓▓▓▒▒▒▓▓▓▓▓▓▓▓▒▒▒▒▒▓▓▓▓▓▒
░░░░░░░░░░░░░░▒▒░▒▓▒▒▒▒▒▒▒▒▒▒▒▒▒▒▒▒▒▒▒▒▒▒▒▒▒▒▒▒▒▒▒▒▒▒▒▒▒▒▒▒▒▒▒▒▒▒▒▒▒▒▒▒▒▒▒▒▒▒▒▒▒▒▒▒▒▒▒▒▒▒▒▒▒▒▒▒▒▒▒▒▒▒▒▒▒▒▒▒▒▒▒▒▒▒▒▒▒▒▒▒▒▒▒▒▒▒▒▒▒▒▒▒▒▒▒▒▒▒▒▒▒▒▒▒▒▒▒▒▒▒▒▒▒▒▒▒▒▒▒▒▒▒▒▒▓▓▓▓▓▓▓▓▓▓▓▓▓▓▓▓▓▓▓▓▓▓▓▓▓▓▓▓▒▓▓▓▒▒▒▓▓▓▓▓▓▓▒▒▒▒▒▓▓▓▓▒▒▒▒▓▓
░░░░░░░░░░░░░░░░▒▒▒▒▒░░░░░░░░░░░░░░░░░░░░░░░░░░░░░░░░░░░░░░░░░░░░░░░░░░░░░░░░░░░░░░░░░░░░░░░░░░░░░░░░░░░░░░░░░░░░░░░░░░░░░░░░░░░░░░░░░░░░░░░░▒▒▒▒▒▒▒▒▒▒▒▒▒▒▒▒▒▒▒▒▒▒▒▒▒▒▒▒▒▒▒▒▒▒▒▒▒▒▒▒▒▒▒▒▒▒▒▓▓▓▓▓▒▒▒▒▒▓▓▓▓▓▒▒▒▒▓▓▓▓▒▒▒▓▓███▒
░░░░░░░░░░░░░░░░░░▒▒░▒▒▒▒░▒░░░░░░░░░░░░░░░░░░░░░░░░░░░░░░░░░░░░░░░░░░░░░░░░░░░░░░░░░░░░░░░░░░░░░░░░░░░░░░░░░░░░░░░░░░░░░░░░░░░░░░░░░░░░░░░░▒▒▒▒▒▒▒▒▒▒▒▒▒▒▒▒▒▒▒▒▒▒▒▒▒▒▒▒▒▒▒▒▒▒▒▒▒▒▒▒▒▒▒▒▒▒▒▒▒▓▓▒▒▒▒▒▒▒▒▓▓▓▓▓▒▓▓▓▓▒▒▒▓▓█▓█░░▒▒
░░░░░░░░░░░░░░░░░░▒░░░░░░░░░░░░░░░░░░░░░░░░░░░░░░░░░░░░░░░░░░░░░░░░░░ ░ ░                                             ░░░░░░░░░░░░░░░░░░░░░░░░░░░░░░░░░░░▒▒▒▒▒▒▒▒▒▒▒▒▒▒▒▒▒▒▒▒▒▒▒▒▒▒▒▒▒▒▒▒▒▒▒▒▓▒▒▒▒▒▒▒▒▓▓▓▓▒▒▓▓▓▓▓█▓▒▒░▒▓░ ▒░
░░░░░░░░░░░░░░░░░░▒░░░░░░░░░░░░░░░░░░░░░░░░░░░░░░░░░░░░░░░░░░░░ ░ ░ ░                                                       ░░░░░░░░░░░░░░░░░░░░░░░░░░░░░░░▒▒▒▒▒▒▒▒▒▒▒▒▒▒▒▒▒▒▒▒▒▒▒▒▒▒▒▒▒▒▒▒▒▒▒▒▒▒▒▒▒▒▒▓▓▒▓▒▒▒▒▓▓▒░   ░▒▓░ ▒░
░░░░░░░░░░░░░░░░░░▒░░░░░░░░░░░░░░░░░░░░░░░░░░░░░░░░░░░░░░░░ ░ ░ ░                                                               ░░░░░░░░░░░░░░░░░░░░░░░░░░░▒░▒▒▒▒▒▒▒▒▒▒▒▒▒▒▒▒▒▒▒▒▒▒▒▒▒▒▒▒▒▒▒▒▒▒▒▒▒▒▒▒▒▓▓▒▒░ ░░▒░     ░▒▓░ ▒░
░░░░░░░░░░░░░░ ░ ░▒░░░░░░░░░░░░░░░░░░░░░░░░░░░░░░░░░░░░░ ░░░ ░ ░  ░                                                                 ░░░░░░░░░░░░░░░░░░░░░░░░░▒▒▒▒▒▒▒▒▒▒▒▒▒▒▒▒▒▒▒▒▒▒▒▒▒▒▒▒▒▒▒▒▒▒▒▒▒▒▒▒▒▓▓▒▒░ ░░▒░     ░▒▓░ ▒░
░░░░░░░░░░░░ ░░░ ░▒░░░░░░░░░░░░░░░░░░░░░░░░░░░░░░░░░░░ ░ ░                                                                              ░░░░░░░░░░░░░░░░░░░░░░░▒▒▒▒▒▒▒▒▒▒▒▒▒▒▒▒▒▒▒▒▒▒▒▒▒▒▒▒▒▒▒▒▒▒▒▒▒▒▒▓▒▒▒░ ░░▒░     ░▒▓░ ▒░
░░░░░░░░░░ ░░░  ░░▒░░░░░░░░░░░░░░░░░░░░░░░░░░░░░░░ ░ ░░ ░  ░                                                                                ░░░░░░░░░░░░░░░░░░░░░▒▒▒▒▒▒▒▒▒▒▒▒▒▒▒▒▒▒▒▒▒▒▒▒▒▒▒▒▒▒▒▒▒▒▒▒▒▓▒▒▒░ ░░▒░     ░▒▓░░▒░
░░░░░░░ ░░░░  ░  ░▒░░░░░░░░░░░░░░░░░░░░░░░░░░░░░░░░░░░                                                                                           ░░░░░░░░░░░░░░░░░▒░▒▒▒▒▒▒▒▒▒▒▒▒▒▒▒▒▒▒▒▒▒▒▒▒▒▒▒▒▒▒▒▒▒▒▓▒▒▒░ ░░▒░     ░▒█▓▓▓░
░░░░░░░░ ░  ░    ░▒░░░░░░░░░░░░░░░░░░░░░░░░░░░░ ░ ░   ░                                                                                              ░░░░░░░░░░░░░░▒░▒▒▒▒▒▒▒▒▒▒▒▒▒▒▒▒▒▒▒▒▒▒▒▒▒▒▒▒▒▒▒▒▒▓▒▒▒░ ░░▒░░▒▓▓▓▓▓▓░ ▒░
░░░░ ░ ░░ ░      ░▒░░░░░░░░░░░░░░░░░░░░░░░░░░ ░░ ░ ░                    ░            ░      ░ ░     ░                                                    ░░░░░░░░░▒▒▒▒▒▒▒▒▒▒▒▒▒▒▒▒▒▒▒▒▒▒▒▒▒▒▒▒▒▒▒▒▒▒▒▒▓▒▒▒░ ░░▓▓▓▒░░ ░▒▓░ ▒░
░░ ░░░░          ░▒░░░░░░░░░░░░░░░░░░░░░░░ ░░ ░ ░                  ░▒▒▒▒▒▒▒▒▒▒▒▒▒▒▒▒▒▒▒▒▒▒▒▒▒▒▒▒▒▒▒▒▒▒▒▒▓▒▒                                                  ░░▒▓▓▓▓▒▓▓▒▒▒▒▒▒▒▒▒▒▒▒▒▒▒▒▒▒▒▒▒▒▒▒▒▒▒▒▒▒▒▒▒▒▒░ ░░▒░     ░▒▓░ ▒░
░░░░    ░        ░▒░░░░▒▒▒▒▒▒▒▒▒▒▒▒▒▒▒░▒░▒▒▒░░░▒▒▒▒▒▒▒▒▒▒▒▒▒     ░▒▒▒▓▒░▒▒▒▒▒▒▒▒▒▒▒▒▒▒▒▒▒▒▒▒▒▒▒▒▒▒▒▒▒▒▒░▒▒▒                                                    ░▒▒▓▓▓▓▒▒▒▒▒▒▒▒▒▒▒▒▒▒▒▒▒▒▒▒▒▒▒▒▒▒▒▒▒▒▒▒▒▒▒▒░ ░░▒░     ░▒▓░ ▒░
░ ░ ░ ░          ░▒░░░▒▒▒▒▒▒▒▒▒▒▒▒▒▒▒▒▒▒▒▒▒▒░░░▒▒░ ░     ░▓▒    ░░▒▒▒▓▒░▒▒▓▓▓▓▓▓▓▓▓▓▓▓▓▓▓▓▓▓▓▓▓▓▓▓▓▓▓▓█▒▒▒▒                                              ░░░░░▒▓▒░▒▒░▒▒▒▒▒▒▒▒▒▒▒▒▒▒▒▒▒▒▒▒▒▒▒▒▒▒▒▒▒▒▒▒▒▒▒▒▒░ ░░▒░     ░▒▓░ ▒░
 ░ ░             ░▒░░░▒▒░░░░░░░░░░░░░░░░░▒▒▒░ ░▒▒░   ░  ░░▓▒    ░░▒▒▒▒▒░▒░▓▒▒▒▒▒▒▒▒▒▒▒▒▒▒▒▒▒▒▒▒▒▒▒▒▒▒▒█▒▒▒▒                                            ░░░▒▒░▒▒▓▒░▒▒ ▒░▒░▒░░░░░▒░▒▒▒▒▒▒▒▒▒▒▒▒▒▒▒▒▒▒▒░▒▒▒▒▒░ ░░▒░     ░▒▓░ ▒░
                 ░▒░░░▒▒░░░░░░░░░░░░░░░░░▒▒▒░░░▒▒░       ░▓▒    ░░▒▒▒▒▒░▒░▒░░▒▒▒▒▒▒▒▒▒▒▒▒▒▒▒▒▒▒▒▒▒▒▒▒▒▓▒▒▒▒                                            ░░░▒▒▒▒▒▓▒░▒▒░▒░▒░▒░░▒░░░░░░░▒░▒▒▒▒▒▒▒▒░░░░░░░░▒▒▒▒░ ░░▒░     ░▒▓░░▒░
                 ░▒░░░▒▒░░░░░░░░░░░░░░░░░▒▒▒░ ▒▒▒░ ░ ░   ░▓▒    ░░▒▒▒▓▒░▒░▒ ░▒▓▒▒▒▒▒▒▒▒▒▒▒▒▒▒▒▒▓▓▓▓▒▒▒▓▒▒▒▒                     ░░▒░▒▒▒▒▒▒▒▒▒▒▒▒▒▒▒▒▒▒▒▒▒▒▒▓▓▓▓▓▓▒▓▓▒▒▒▒▒▓▒▒▒▒░░░░░░░░░░░░░▒▒▒░░░░░░░░▒▒▒▒░ ░░▒░   ░░▒▓▓▓▓▓░
                 ░▒░░░▒▒░░░░░░░░░░░░░░░░░▒▒▒░░░▒▒░     ░ ░▓▒    ░░▒▒▒▒▒░▒░▒ ░▒▒░               ░▒▒▓▒▒▒▓▒▒▒▒                     ░▒▒▒▒▒▒▒▒▒▒▒▒▒▒▒▒▒▒▒▒▒▒▒▒▒▒▒▒▒▒▒▒▒▒▒▒▒▒▒▒▒▒▒░▒░░░░░░░░░░░░░░▒▒░░░░░░░░▒▒▒▒░ ░░▒▒▓▓▓▓▒▒▒▓░ ▒░
                 ░░░░░▒▒░░░░░░░░░░░░ ░░░░▒▒▒░ ▒▓▓▒▒▒▒▒▒▒▒▓▓▒    ░░▒▒▒▒▒░░░▒ ░▒▒░               ░░▒▓▒▒▒▓▒▒▒▒                   ░░▒▓▒▒▓▓▓▓▓▓▓▓▓▓▓▓▓▓▓▓▓▓▓▓▓▓▓▓▓▓▓▓▓███▓▓▓▓▓▓░▒░▒░░░░░░░░░░░░░░▒▒░░░░░░░░▒▒▒▒░ ░▒▓▒░░░  ░▒▓░ ▒░
                 ░▒░░░▒▒░░░░░░░░░░ ░░░ ░░▒▒▒░ ░░░░░░░░░░░░░    ░░░▒▒▒▒▒░░░▒ ░▒▒░               ░░▒▓▒▒▒▓▒▒▒▒               ░░▒▒▒▒▓▓░▒▒▒▒▒▒▒▒▒▒▒▒▒▒▒▒▒▒▒▒▓▓▓▓▒▒▒▓▓▓▓▓▓▓▓▓▓▓▓░▒░▒░░░░░░░░░░░░░░▒▒░░░░░░░░▒▒▒▒░ ░░▒░     ░▒▓░ ▒░
                 ░▒░░░▒▒░░░░░░░░ ░░░ ░░░░▒▒▒░░░▒▒▒▒▒▒▒▒        ░░░▒▒▒▒▒░░░▒ ░▒▒░               ░░▒▓▒▒▒▓▒▒▒▒           ░░░▒▒▒▒▒▒▒▓▓░▒▒▒░░▒▒▒▒▒▒▒▒▒▒▒▒▒▒▒▒▒▒▒▒▒▒▓▓▓▓▒▒▒▒▓▓▓▓░▒░▒░░░░░░░░░░░░░░▒▒░░░░░░░░▒▒▒▒░ ░░▒░     ░▒▓░ ▒░
                 ░▒░░░▒▒░░░░░░░░░░ ░░░ ░░▒▒▒░░▒▒▒▒▒▒▒▒▓░       ░░░▒▒▒▒▒░░░░ ░▒▒░               ░░▒▓▒▒▒▓▒▒▒▒       ░░░░▒▒▒▒▒▒▒▒▒▒▓▓▒▒▒▒░░▒▒▓▒▒▒▒▒▒▒▒▒▒▒▓▒▒▒▓▓▒▒▓▒▒▒░░░░█▓▓▓░▒░▒░░░░░░░░░░░░░░▒▒░░░░░░░░▒▒▒▒░ ░░▒░     ░▒▓░ ▒░
                 ░▒░░░▒▒░░░░░░░░░░░░░░░░░▒▒▒░░▒▒▒▒▒▒▒▒▒░       ░ ░▒▒▒▒▒░░░░ ░▒▒░               ░░▒▓▒▒▒▓▒▒▒▒   ░░░░░░░▒▒▒▒▒▒▒▒▒▒▒▓▓▒▒▒▒▒▒▒▒▓▒▒▒▓▓▒▒▒▒▓▓▓▒░▒▓▓▓▓▓▓▒▒░░░▓▓▓▓▓░▒░▒░░░░░░░░░░░░░░░▒░░░░░░░░▒▒▒▒░ ░░▒░     ░▒▓░ ▒░
                 ░▒░░░▒▒▒▒▒▒▒▒▒▒▒▒▒▒▒▒▒▒▒▒▒▒░░                 ░░░▒▒▒▒▒░░░░ ░▒▒░               ░░▒▓▒▒▒▓▒▒▒▒░░░░░░░░░░▒▒▒▒▒▒▒▒▒▒▒▓▓░▒▒▒▒▒▒▒▒▒▒▒▒▒▒▒▒▒▒▒▒▒▒▒▒▒▒▒▒▒▒▒▒▒▒▒▒▒▒▒░▒░▒░░░░░░░░░░░░░░░▒░░░░░░░░▒▒▒▒░ ░░▒░     ░▒▓░░▒░
                 ░▒░░░░░░▒░▒░▒░░░░░░▒░▒░░░░░░ ░ ░ ░▒▒▒▒▒▒▒▒▒▒▒▒░░░▒▒▒▒▒░░░░ ░▒▒░               ░░▒▓▒▒▒▓▒▒▒▒  ░░░░░░░▒▒▒▒▒▒▒▒▒▒▒▒▓▓░▒▓▓▓▓▓▓▓▓▓▓▓▓▓▓▓▓█▒▓█▓▓▓▓▓▓▓▓▓▓▓▓▓▓█▓▓▓░▒░▒░░░░░░░░░░░░░░░▒░░░░░░░░▒▒▒▒░ ░░▒░░░▒▒▓▓▓█▓▒▒░
                 ░▒░░░░░░░░░░░░░░░░░░ ░ ░ ░ ░ ░   ▒▒         ░▒▒ ░▒▒▒▒▒░░░░ ░▒▒░               ░░▒▓▒▒▒▓▒▒▒▒  ░░░░░░▒▒▒▒▒▒▒▒▒▒▒▒▒▓▓▒▒▒▒▒▒▒▒▒▒▒▒▒▒▒▓▒▒▓▒▓▒▓▒▓▓▒▒▒▒▒▒▒▓▓▓▓▓▓▓░▒░▒░░░░░░░░░░░░░░░░░░░░░░░░▒▒▒▒░ ░░▓▓▓▒▒░ ░▒▓░ ▒░
                 ░░░░░▒▒▒▒▒▒▒▒▒▒▒▒▓▓░░ ░▒▒▒▒▒▒▒▒▒░▒▒░        ░▒▒ ░░▒▒▒▒░░░░ ░▒▒░               ░░▒▓▒▒▒▓▒▒▒▒  ░░░░▒▒▒░░░░░▒▒▒▒▒▒▒▓▓▒▒▒▒▒▒▒▒▒▒▒▒▒▒▓▓▒▒▒▒▒░▒░░░▒▓▓▓▒▒▓▓▓▓▓▓▒▓░▒░▒░░░░░░░░░░░░░░░░░░░░░░░░▒▒▒▒░ ░░▒░     ░▒▓░ ▒░
                 ░░░░░▒▒▒░░░░░░░░▒▓▓░░ ░▒░░ ░ ░▒▒░▒▒         ░▒▒░░░▒▒▒▒░░░░ ░▒▒░               ░░▒▓▒▒▒▓▒▒▒▒  ░░▒▒▓▒▒░    ░▒▒▒▒▒▒▓▓░▒▓▓▒▒▒▒▒▒▒▓▒▒▓▓▒▒▒▒▒░▒░░░░▒▒▒░▒▓▒▓▒▓▒▒▓░▒░░░░░░  ░ ░  ░ ░░░░░░░░░░░▒▒▒▒░ ░░▒░     ░▒▓░ ▒░
                 ░▒░░░▒▒░░░░░░░ ░░▒▓░░░░▒▒▒▒▒▒▒▓▒░▒▒░        ░▒▒ ░▒▒▒▒▒░░░░ ░▒▒░               ░░▒▓▒▒▒▓▒▒▒▒░▒▒▒▒▓▒▒▒     ░▒▒▒▒▒▒▓▓▒▒▓▓▒░░▒░▒▒▒▒▒▓▓▒▒▒▒▒░▒░░░░▒░▒░▒▒▒▓▒▓▓▒▓░▒░░ ░░░          ░░░░░░░░░░▒▒▒▒░ ░░▒░     ░▒▓░ ▒░
                 ░░░░░▒▒░░░░ ░░░░░▒▓░░░░░░░░░░░░  ▒▒░        ░▒▒ ░░▒▒▒▒░░░▒ ░▒▒░               ░░▒▓▒▒▒▓▒▒▒▓▒▒▒▒▒▓▒▒▒      ░▒▒▒▒▒▓▓▒▒▓▓▒▒▒▒▒▒▒▒▒▓█▓▒▒▓▓▓▒▒▒▒░▒▒▒▒░▒▒▒▓▓▓▓▓▓░▒░░  ░░          ░░   ░   ░▒▒▒▒░ ░░▒░     ░▒▓░ ▒░
                 ░▒░░░▒▒░░░░░░░░░░▒▓░░   ░        ▒▒░        ░▒▒ ░░▒▒▒▒░░░░ ░▒▒░               ░▒▒▓▒▒▒▓▒▓▒▓▒▒▒▒▓▒▒▒▒░▒░░░░░▒▒▒▒▒▓▓░▒▓▒▒▒▒▒▒▒▒▒▒▒▒▒▒▒▒▒▒▒▒▒▒▒▒▒▒▒▒▒▒▒▒▒▒▒▒▒░▒░░  ░░          ░░       ░▒▒▒▒░ ░░▒░     ░▒▓░ ▒░
                 ░░░░░▒▒░░ ░░░░ ░░▒▓░░░░          ▒▒░░░░░░░░░░▒▒░░░▒▒▒▒░░░▒ ░▒▒░               ░▒▒▓▓▒▒▓▒▓▒▓▒▒▒▒▒▓▓▓▓▓▓▓▓▓▓▓▒▒▒▒▒▓▓░▒▓▓▓▓▓▓▓▓▓▓▓▓▓▓▒▒▓▓▓▓▒▒▓▓▓▓▓▓▓▓▓▓▓▓▓▓▒▒░▒░░  ░░          ░░        ▒▒▒▒░ ░░▒░   ░░░▒▓▒░▒░
                 ░▒░░░▒▒░░░░░░░░░░▒▓░░ ░ ░ ░ ░ ░  ▒▒▒▒▒▒▒▒▒▒▒▒▒░ ░░▒▒▒▒░░░▒ ░▒▒░            ░░░▒▒▒▓▓▓▓█▒▓▒▓▒▒▒▒▒▒▒▒▒▒▓▓▒▒▒▒▒▒▒▒▒▓▓░▒▓▒▒▒▓▓▓▓▓▒▒░▒▒░░▒▒▒▒░▒░▒▒▒▓▒▒▓▒▓▓▓▓▓▒▒░▒░░  ░░          ░░        ▒▒▒▒░ ░░▒▓▓▓▓▓▓▓▓▓▓▒▒░
                 ░░░░░▒▒▒▒░░░░░░░▒▒▓░░ ░ ░                      ░░░▒▒▒▒░░░▒ ░▒▒░          ░░▒▒▒▒▒▓▓▓▓▓█▒▓▒▓▒▒▒▒▒▒▒▒▒▒▒▒▒▒▒▒▒▒▒▒▒▓▓░▒▒▒░░▒▒▒▒▒░░░▒▒░░▒▒▒▒░░░▒░▒▒▓▓▓▒▒▓▓▓▓▒▒░▒░░   ░          ░░        ▒▒▒▒░ ░░▒░     ░▒▓░ ▒░
                 ░▒░░░░░▒░▒░░▒▒░░▒░░░░ ░   ░  ░                  ░░░▒▒▒░░░▒ ░▒▓▓▓▓▓▓▓▓▓▓▓▓▓▓▓▓▓▓▓██▓▓▓█▒▓▒▓▒▒▒▒▒▒▒▒▒▒▒▒▒▒▒▒▒▒▒▒▒▓▓░▒▒▒░░▒░░▒▒░░░▒▒░░▒▒▒▒░░░▒░▒▒░▒▓░▒▓▓▓▓▒▓░▒░░  ░           ░░        ▒▒▒▒░ ░░▒░     ░▒▓░ ▒░
                 ░░░░░░░░░░░░░░░░░░░ ░ ░ ░  ░ ░                 ░░░▒▒▒▒░░░▒ ░░░░ ░░ ░░ ░ ░░░░▒▒▒▒▒▒▒▒▒▓▒▓▒▓▒▒▒▒▒▒▒▒▒▒▒▒▒▒▒▒▒▒▒▒▒▓▓░▒▓▒▒▒▒▒▒▒▒▒▒▒▒▒▒▒▒▒▒▒▒▒▒▒▒▒▒▒▒▒▒▒▒▓▓▓▒▓░▒░░  ░           ░░        ▒▒▒▒░ ░░▒░     ░▒▓░ ▒░
   ░             ░▒░░░░░░░░░░░░░ ░ ░░ ░   ░   ░░                 ░░▒▒▒▒░▒░▒ ░▒▒▒▒▒▒▒▒▒▒▒▒▒▒▒▒▓▓▓▓▓▓▒▒▒▓▒▓▒▓▒▒▒▒▒▒▒▒▒▒▒▒▒▒▒▒▒▒▒▒▒▒▓░▒▓▓▓▓▓▓▓▓▓▓▓▓▓▓▓▓▓▓▓▓▓▓▓▓▓▓▒▓▒▓▒▓▓▓▓▓▓▓░▒░░  ░░          ░░ ░      ▒▒▒▒░ ░░▒░     ░▒▓░ ▒░
░  ░    ░        ░░░░░░░░ ░░░░░▒▒░░░░░░░░░░░░░░░░▒▒░           ░ ░░░▒▒▒░░░▒ ░▒▒▒░░░░░░░░░░▒▒▒▒▒▒▒▒▓▒▒▒▓▒▓▒▒▒▒▒▒▒▒▒▒▒▒▒▒▒▒▒▒▒▒▒▒▒▓▓░▒▓▒▓▓▓▓▓▓▓▓▓▓▓▓▓▓▓▒▓▓▓▓▓▒▒▒▒▒▒▓▓▓▓▓▓▓▒▒░▒░░  ░░          ░░ ░░   ░ ▒▒▒▒░ ░░▒░     ░▒▓░ ▒░
░  ░ ░ ░░ ░      ░▒░░░░░░░░░▒▒▒░                   ░▒░ ░       ░ ░░░▒▒▒░▒░▒ ░░░░░░░░░░░░░░░░▒▒▒▒▒▒▒▒▒▒▓▒▓▒▒▒▒▒▒▒▒▒▒▒▒▒▒▒▒▒▒▒▒▒▒▒▒▓░▒▒▒▒▒▒▒▒▒▓▓▓▒▒▒▒▒▓▒▓▒▒▓▓▓▒▒▒▒▒▓▓▓█▓▓▓▒▒░▒░░  ░░   ░    ░ ░░░░░  ░  ▒▒▒▒░ ░░▒░     ░▒▓░ ▒░
░  ░ ░ ░░ ░   ░  ░▒░░░░░░░▒▒▓▒░                     ░▒░░       ░ ░░░▒▒▒░░░▒ ░▒▒▒▒▒▒▒▒▒▒▒▒▒▒▒▒▓▓▓▓▓▓▒▒▒▓▒▓▒▒▒▒▒▒▒▒▒▒▒▒▒▒▒▒▒▒▒▒▒▒▒▓▓░░▒▒▒░░░░░▒▒▒░▒▒░░▒▒▒▒▒▒▒▒▒▓▓▒▒▒▓▒▓▓▓▓▒▒░▒░░  ░░   ░   ░░ ░░░░░░ ░░ ▒▒▒▒░ ░░▒▒▒▒▒▒▒▒▒▓▒▒▒▒
░  ░ ░ ░░ ░ ░ ░  ░▒░░░░░░▒▒▓▓▒░                     ░▓▒▒░▒░░░░ ░ ░░░▒▒▒░░░▒ ░▒▒░░░░░░░░░░░░░▒▒▒▒▒▒▓▒▒▒▓▒▓▒▒▒▒▒▒▒▒▒▒▒▒▒▒▒▒▒▒▒▒▒▒▒▒▓░░▒▒▒░░░░░░▒▒░▒▒░░▒▒▒▒░░░▒▓▓▒░  ░▒▓▓▓▓▒▒░▒░░  ░░   ░   ░░ ░░░░░░░░░░▒▒▒▒░░▒▒▒▒▒▒▒▒▒▒▒▒▒▒▒▒
░  ░ ░ ░░░░░░░░  ░▒░░░░░▒▒░░░▒▒                     ░▓▒▓▓▒▒▒▒▒▒░ ░░░▒▒▒░░░▒ ░▒▒░            ░░░▒▒▒▓▒▒▒▓▒▓▒▒▒▒▒▒▒▒▒▒▒▒▒▒▒▒▒▒▒▒▒▒▒▒▓░░▒▒▒▒▒▒▒▒▒▒▒▒▒▒▒▒▓▓▓▒▒▒▒▓▓▓▓▒░░▒▓▓▓▓▓▓▓░▒░░  ░░  ░░   ░░ ░░░░░░▒▒▒▒▒▒▒▒▒▒▒▒▒▒▒▒▒▒▒▒▒▒▓▓▓▓
░  ░ ░ ░░ ░░░░░ ░░▒░░░░▒▓▒▒░░░▒░                 ░▒▒▒▓▒▒▓░▒░ ░▒░ ░░░▒▒▒░░░▒ ░▒▒░            ░░░▒▒▒▓▒▒▒▓▒▓▒▒▒▒▒▒▒▒▒▒▒▒▒▒▒▒▒▒▒▒▒▒▒▓▓░░▒▒▒▒▒▒▒▒▒▒▒▒▒▒▒▒▒▒▒▒▒▒▒▒▒▒▒▒▒▒▒▒▒▒▒▒▒▓░▒░░  ░░  ░░   ░░ ░░░░░░░░░░▒▒▒▒▒▒▓▓▓▓▓▓▓▓▓▓▓▓▓▓▓▓
░  ░ ░ ░░░░░░░░ ░░▒░▒▒▒▒▓▒▒░ ░▒░              ░▒▒▒▒▒▒▓▒▒▓░▒░ ░▒░ ░░▒▒▒▒░░░▒ ░▒▒░            ░░░▒▒▒▓▒▒▒▓▒▓▒▒▒▒▒▒▒▒▒▒▒▒▒▒▒▒▒▒▒▒▒▒▒▓▓░░░░░░░░░░░░░░░░░░▒▒░░░░░░░░░░░░░░░░░▒▓▒░▒░░  ░░  ░░   ░░ ░░░░░░░░░░░▒░▒▒▒▒▒▒▒▒▒▒▒▒▒▓▒▒▒▓▒
░░ ▒░▒░░░░░░░░▒░▒▒▓▒▒▒▒▓▓▒▒░ ░▒▒░▒░▒░░░░░░░░▒▒▒▒▒▒▒▒▓▓▒▒▓░▒░ ░▒░ ░░▒▒▒▒░░░▒ ░▒▒░            ░░░░▒▒▓▒▒▒▓▒▓▒▒▒▒▒▒▒▒▒▒▒▒▒▒▒▒▒▒▒▒▒▒▒▓▓░░░░░   ░▒▒▒░░    ▒▒░░░░    ░▒▒▒░    ▒▒▒░▒░░  ░░  ░░   ░░░░▒░░░░░░░░▒░░▒▒░▒▒▒▒▒▒▒▒▒▒▓▒▒▒▓▒
▒▒▒▒▒▒░░░░▒░▒▒▒▒▒▒▓▒▒▒▒▓▓▒▒░ ░▒▓▒░░░░░░░░░░░░░░░░░░░░░▒▓▓░▒░ ░▒░ ░░▒▒▒▒░▒░▒ ░▒▒░            ░░░░▒▒▓▒▒▒▓▒▓▒▒▒▒▒▒▒▒▒▒▒▒▒▒▒▒▒▒▒▒▒▒▒▒▓░░░░░░░▒▒▒▒▒░░░░░░▒▒░░░░░░░▒▒▒▒▒░░░░░▒▓▒░▒░░  ░░  ░░  ░░▒░▒▒░▒░▒░░▒░▒▒░▒▒▒▒▒▒▒▒▒▒▒▒▒▓▒▒▒▓▒
▒▒▒▓▒▒▒░▒░▒░▒▒▓▒▒▓▓▒▒▒▒▓▓▒▒░ ░▒▒░                      ▒▓░▒░ ░▒░ ░░▒▒▒▒░▒░▒ ░▒▒░            ░░░░▒▒▓▒▒▒▓▒▓▒▒▒▒▒▒▒▒▒▒▒▒▒▒▒▒▒▒▒▒▒▒▒▓▓░░░░░░░░░░░░░░░░░░░▒░░░░░░░░░░░░░░░░░▒▒▒░▒░░ ░░░  ░░░░░▒▒░▒▒░▒▒▒░░▒░▒▒░▒▒▒▒▒▒▒▒▒▒▒▒▒▓▒▒▒▓▒
▓▒▒▓▒▒▒░▒░▒░▒▒▓▒▒▓▓▒▒▒▓▓▓▒▒░ ░▒▓▒░░░░░░░░░░░░░░░░░░░░░▒▓▓░▒░ ░▒░ ░░▒▒▒▒░░░▒ ░▒▒░            ░░░░▒▒▓▒▒▒▓▒▓▒▒▒▒▒▒▒▒▒▒▒▒▒▒▒▒▒▒▒▒▒▒▒▓▓░░░░░░░░░░░░░░░░░░▒▒░░░░░░░░░░░░░░░░░▒▒▒░▒░░  ░░  ░▒░░░▒▒░▒▒░▒▒▒▒░▒░▒▒░▒▒▒▒▒▒▒▒▒▒▒▒▒▓▒▒▒▓▒
▓▒▒▓▒▓▒░▒░▒░▒▒▓▒▒▓▓▒▓▓▓▓▓▒▒░ ░▒▓▓▒▒▒▒▒▒▒▒▒▒▒▒▒▒▒▒▒▒▒▒▒▒▒▓░▒░ ░▒░ ░░▒▒▒▒░▒░▒ ░▒▒░            ░░▒░▒▒▓▒▒▒▓▒▓▒▒▒▒▒▒▒▒▒▒▒▒▒▒▒▒▒▒▒▒▒▒▒▓▓░░░░░    ░░░░     ▒▒░░░░     ░▒░░    ▒▒▒░▒░░ ░░░░░▒▒░░░▒▒░▒▒▒▒▒▒▒░▒▒▒▒░▒▒▒▒▒▒▒▒▒▒▒▒▒▓▒▒▒▓▒
▓▒▒▓▒▓▒░▒░▒░▓▒▓▒▓▓▓▓▓▓▓▓▓▒▒░ ░▒▒░ ░                    ░▒░▒░ ░▒░ ░░▒▒▒▒░░░▒ ░▒▒▓▒▓▓▒▓▓▓▓▓▓▓▓▓▓▓▓▓▓▓▒▒▒▓▒▓▒▒▓▒▒▒▒▒▒▒▒▒▒▒▒▒▒▒▒▒▒▒▓▓▓░░░░░   ░▒▒▒░     ▒▒░░░░   ░▒▒▓▒░    ▒▒▒░▒░░░░▒▒░░▒▒▒▒▒▒▒▒▒▒▒▒▒▒▒▒▒▒▒▒▒▒▒▒▒▒▒▒▒▒▒▒▒▒▓▒▒▒▓▒
▓▒▒▓▒▓▒░▒░▒░▓▓▓▓▓▓▓▓▓▓▓▓▓▒▒░░░▒▒░░░░░░░░░░░░░░░░░░░░░░░░▓▒▒░░░▒░░░░▒▒▒▒░▒░▒ ░░░░░░░░░░░░░░░░▒▒▒▒▒▒▒▒▒▒▓▒▓▒▒▓▒▒▒▒▒▒▒▒▒▒▓▒▒▒▓▒▒▒▓▓▓▓░░░░▒▒▒▒▒▒▒▒▒▒▒▒▒░▒▒░░░▒▒▒▒▒▒▒▒▒▒▒▒▒░▒▓▒░▒░▒▒▒▒▒▒▒▒▒▒▒▒▒▒▒▒▒▒▒▒▒▒▒▒▒▒▒▒▒▒▒▒▒▒▒▒▒▒▒▒▒▓▒▒▒▓▒
▓▒▒▓▓▓░░▒▒▒▒███▓▓████████████▓▓████████████████████▓▓▓▓▓▓▒▓▒▒▒▒▒▒▒▒▒▓▓▒░▒░▒                 ░░░░░▒▒▒▒▒▓▒▓▒▒▓▓▓▓▓▓▓▓▓▓▒▓▓▓▓▓▓▓▓▓▓▓▓░░▒▒▒▒▒▒▒▒▒▒▒▒▒▒▒▒▒▒░▒▒▒▒▒▒▒▒▒▒▒▒▒▒▒▒▒▒▓▒▒▒▓▓▓▓▓▓▓▓▓▓▓▓▓▓▓▓▓▓▓▓▓▓▒▒▒▒▒▒▒▒▒▒▒▒▒▒▒▒▒▒▒▓▒▒▒▓▒
▓▓▓▓▓▓▓▓▓▓▓▓▓▓▓▓▓▓▓▓▓▓▓▓▓▓▓▓▓▒▒▓▓▓▓▓▓▓▓▓▓▓▓▓▓▓▓▓▓▓▒░░ ░░▓░▒        ░░▓▒░▒░▒                 ░░░░▒░▒▒▒▒▓▒▓▒▒▓▒▒▒▒▒▒▒▒▓▒▓▒▒▒▒▒▒▒▒▒▓▓▒░░░░░░░░░░░░░░░░░░░░░░░░░░░░░░░░░░▒▒▒▒▒▒▒▒▒▒▒▒▒▒▒▒▒▒▒▒▒▒▒▒▓▒▒▒▒▒▒▓▓▓▓▓▓▓▒▓▒▒▒▒▒▒▒▒▒▓▒▒▒▓▒
▓▓▓▓▓▓▓▓▓▓▓▓▓███████████▓███▓▒▒███████████▓▓▓█▓▓▒▒░▒▒░░░▓░▒▒░░░░▒░░░░▒░░░░▒░░░▒░░░░░░▒░░░░▒░░░░░▒░░░░░▒▒▒░▒▒▒▒▒▒▒▓▓▓▓▒▓▓▓▓▒▓▓▓▓▓▓▓▓▒▓▓▓▓▓▓▓▓▓▓▓▓▓▓▓▓▓▓▓▓▓▓▓▓▓▓▓▓▓▓▓▓▓▓▓▓▓▓▒▓▓▓▒▒▒▒▓▒▒▒▒▒▓▒▒▒▓▓▓▓▓▓▓▒▒▒▒▒▒▒▒▓▓▓▓▓▓▓▓▓▒▒▓▒▒▒▓▒
▒▒▓▓▓▓▓▓██▓▓▓▓▓▓▓▓▓▓▓▓▓▓▓▓▓▓▓▒▒█▓▓▓▓▓▓▓▓▓▓▓▓▓▓▓▓▓▒░░ ░░░▓░▒ ░░░░  ░░░  ░░░  ░░░    ░░░   ░░░    ▒░    ░░     ░░▒▓▓▒▒▒▒▒▒▒▒▒ ░░ ░▒▒░░░░░░  ░░░░░ ░░▒▒▒░ ░░░░░░░░░░░░░░░░░░░▒▒░░░░░░▒░░░▒▒▒▒▒▒▒▒▒▒▒▒▒▓▓▓▓▓▓▓▒▒▒▒▒▒▒▒▓▓▓▓▓▓▓▓▓▓
▒▒▒▒▒▒▒▓▓▓▓▓▓▓▓▓▓▓▓▓▓▓▓▓▓▓▓▓▓▒▒▒▒░░░▒▒▒░░░░░░░░░░░▒▒▒▒░░▒▒▒▒░   ░░░  ░░░  ░░░     ░░     ░░     ▒░     ▒░    ░░ ▒░░░░░░░░░   ░░ ░▒▒░   ░░░   ░░░░   ░▒▒░░  ░░░░  ░░░░  ░░░░░ ░░░░░░░░░░░░░░▒▒▒▒▒▒▒▒▒▒▒▒▒▒▓▓▓▓▓▓▓▓▓▒▒▒▒▒▓▓▓▓▓
░░░░░░░░░░░░░░░░░░░░░░░░░░░░░░░░░░░░░ ░░░░░░  ░░░░    ░▒▒▒    ░░░   ░░░  ░░░    ░░░     ░░     ░░░     ▒░     ▒  ░      ░░░   ░░░ ░▒▒░   ░░░    ░░░   ░░▒▒░░  ░▒░░  ░░░░░  ░░░░░░ ░░░░░░ ░░░░░░░▒▒▒▒▒▒▒▒▒▒▒▒▒▓▓▓▓▓▓▓▓▓▓▓▓▓▓▓
░░░░░▒▒░░░░░░▒░░ ░░░░░░   ░░░░░░  ░░░░░░  ░░░▒░    ░░▒▒░    ░░░   ░░░   ░░     ░░░     ░░░     ░░      ▒░     ░▒ ░░      ░░░   ░░░ ░▒▒░    ░░░    ░░░    ░░▒▒░   ░▒▒░░  ░░▒░░  ░░▒░░░  ░░░░░░ ░░░░░░░░▒▒▒▒▒▒▒▓▒▒▒▓▓▓▓▓▓▓▓▓▓▓
▒▒░░░░░▒▒░░░░░░▒▒░░ ░░░░▒▒░   ░░░▒░░   ░░▒░░    ░░▒▒░     ░▒░   ░░░   ░▒░     ░░░      ░░      ▒░      ▒░      ░░░▒░░     ░░░   ░░░  ░▒▒░    ░░░    ░▒░░    ░▒▒▒░   ░▒▒░░   ░▒▒░░   ░▒▒░░   ░▒░░░░ ░░▒░░░░░▒▒▒▒▒▒▒▓▓▓▓▓▓▓▓▓▓
░▒▒▒░░░░░░▒▒░░░░░ ░░▒░░    ░░▒░     ░░▒░      ░▒▒▒░     ░▒     ░░    ░░      ░░░      ░░       ░░      ▒░       ▒ ▒░▒       ░░    ░░  ░░▒░     ░░░     ░▒░     ░▒▒░    ░▒▒▒░    ░▒▒░    ░░▒░░    ░▒▒░ ░ ░░▒▒░░░░▒▒▓▓▒▒▒▓▓▓▓▓
░░░░░▒▒░░░░░░░░▒▒░░░░░ ░░▒░░░    ░▒░░░     ░▒░▒░░     ░░░    ░░░   ░▒░      ░░░      ░░░      ░░░      ░░░      ░░░▒ ▒       ░░    ░░  ░░▒░░    ░░░░     ░▒▒░░   ░░▒▒░   ░░▒▒▒░    ░░░▒░   ░░░▒▒░  ░░░░▒░░░░░░░▒▒░░░░▒▒▓▓▓▓▓
▒▒░░░░░░░░▒▒░░░░░░░░░▒░░░░░░░░░▒░░░ ░   ░░░▒░░     ░░░░     ░░   ░░░░      ░▒░      ░░░       ▒░        ▒░       ░░▒░░░      ░░░    ░░   ░▒▒░     ░░░░     ░░▒▒░    ░▒░░░   ░░░▒▒▒░   ░░░░▒░ ░ ░░░░▒░░░░░░░▒▒░░░░░░░▒▒▒░░░░▒
░░░░░░▒▒░░░░░░░░░▒░░░░░░░░░░░░░░░░░░░░░░░▒░░░ ░ ░░░▒░░    ░░░   ░▒░       ░▒░       ░░        ▒░        ▒░       ░▒░▒░░░      ░░▒    ░░░  ░░▒░░     ░░░░     ░░▒▒░░   ░░▒░░░   ░░░▒▒░░░ ░░░░░░░░░░░░░░░▒░░░░░░░░▒▒░░░░░░░▒▒▒
░▒▒▒▒░░░░░░░▒▒▒▒░░░░░░░░▒▒░░░░░░░░░░▒▒▒▒░░░░░░░░▒▒▒░░░░░░▒░░░░░▒▒░░░░░░░░░▒░░░░░░░░░▒░░░░░░░░░▒░░░░░░░░░▒░░░░░░░░░░░▒░░▒░░░░░░░░░▒░░░░░░░░░░░▒▒░░░░░░░░▒▒░░░░░░░░▒▒▒░░░░░░▒░▒▒░░░░░░▒▒▒▒░░░░░░░░▒▒░░░░░░░▒▒▒░░░░░░▒▒▒▒▒░░░░░