███████████████████████████████████████████████████████████████████████████████████████████████████████████████████████████████████████████████████████████████████████████████████████████████████████████
███████████████████████████████████████████████████████████████████████████████████████████████████████████████████████████████████████████████████████████████████████████████████████████████████████████
████████████████████████████████████████████████████████████████████████████████████████████████████████████████████████████████████████████████████████████████████████████████████████████████████▓██████
████▓▓▓▓▓████████████████████████████████████████████████████████████████████████████████████████████████████████████████████████████████████████████████████████████████████████████████████▓▓▓▓▓▓▓▓▓▓████
████▓▓▓▓▓▓▓▓▓▓▓████████████████████▓█▓█▓▓▓▓▓▓▓▓▓▓▓▓▓▓▓▓▓▓▓▓▓▓▓▓▓▓▓▓▓▓▓▓▓▓▓▓▓▓▓▓▓▓▓▓▓▓▓▓▓▓▓▓▓▓▓▓███▓▒▒▒▓███▓▓▓▓▓▓▓▓▓▓▓▓▓▓▓▓▓▓▓▓▓▓▓▓▓▓▓▓▓▓▓▓▓▓▓▓▓▓▓▓▓▓▓▓▓▓▓█▓▓▓█████████████████████████▓▓▓▓▓▓▓▓▓▓▓▓▓▓▓▓▓████
████▓▓▓▓▓▓▓▓▓▓▓▓▓▓▓▓█████████▓▓▓▓▓▓▓▓▓▓▓▓▓▓▓▓▓▓▓▓▓▓▓▓▓▓▓▓▓▓▓▓▓▓▓▓▓▓▓▓▓▓▓▓▓▓▓▓▓▓▓▓▓▓▓▓▓▓▓▓▓▓▓▓██▓░▒░░▒░░░▒██▓▓▓▓▓▓▓▓▓▓▓▓▓▓▓▓▓▓▓▓▓▓▓▓▓▓▓▓▓▓▓▓▓▓▓▓▓▓▓▓▓▓▓▓▓▓▓▓▓▓▓▓▓▓▓▓▓▓▓██████████▓▓▓▓▓▓▓▓▓▓▓▓▓▓▓▓▓▓▓▓▓▓▓████
████▓▓▓▓▓▓▓▓▓▓▓▓▓▓▓▓▓▓██████▓▓▓▓▓▓▓▓▓▓▓▓▓▓▓▓▓▓▓▓▓▓▓▓▓▓▓▓▓▓▓▓▓▓▓▓▓▓▓▓▓▓▓▓▓▓▓▓▓▓▓▓▓▓▓▓▓▓▓▓▓▓▓▓██▒▒░░░░▒░  ░▒▓█▓▓▓▓▓▓▓▓▓▓▓▓▓▓▓▓▓▓▓▓▓▓▓▓▓▓▓▓▓▓▓▓▓▓▓▓▓▓▓▓▓▓▓▓▓▓▓▓▓▓▓▓▓▓▓▓▓▓▓▓█████▓▓▓▓▓▓▓▓▓▓▓▓▓▓▓▓▓▓▓▓▓▓▓▓▓▓████
████▓▓▓▓▓▓▓▓▓▓▓▓▓▓▓▓▓▓▓██▓█▓▓▓▓▓▓▓▓▓▓▓▓▓▓▓▓▓▓▓▓▓▓▓▓▓▓▓▓▓▓▓▓▓▓▓▓▓▓▓▓▓▓▓▓▓▓▓▓▓▓▓▓▓▓▓▓▓▓▓▓▓▓▓▓▓█▒░░░  ░▒░  ░░░██▓▓▓▓▓▓▓▓▓▓▓▓▓▓▓▓▓▓▓▓▓▓▓▓▓▓▓▓▓▓▓▓▓▓▓▓▓▓▓▓▓▓▓▓▓▓▓▓▓▓▓▓▓▓▓▓▓▓▓▓████▓▓▓▓▓▓▓▓▓▓▓▓▓▓▓▓▓▓▓▓▓▒▓▒▓▓████
████▒▒▓▓▓▓▓▓▓▓▓▓▓▓▓▓▓▓▓█▓▓▓▓▓▓▓▓▓▓▓▓▓▓▓▓▓▓▓▓▓▓▓▓▓▓▓▓▓▓▓▓▓▓▓▓▓▓▓▓▓▓▓▓▓▓▓▓▓▓▓▓▓▓▓▓▓▓▓▓▓▓▓▓▓▓▓▓█▒▒░  ░▒▒▒░  ░▒▓█▓▓▓▓▓▓▓▓▓▓▓▓▓▓▓▓▓▓▓▓▓▓▓▓▓▓▓▓▓▓▓▓▓▓▓▓▓▓▓▓▓▓▓▓▓▓▓▓▓▓▓▓▓▓▓▓▓▓▓▓▓▓▓█▓▓▓▓▓▓▓▓▓▓▓▓▓▓▓▓▓▓▓▒▒▒▒▒▒▓████
████▒▒▒▒▒▓▓▓▓▓▓▓▓▓▓▓▓▓▓▓▓▓▓▓▓▓▓▓▓▓▓▓▓▓▓▓▓▓▓▓▓▓▓▓▓▓▓▓▓▓▒▓▒▓▒▒▓▒▓▒▓▒▓▒▓▒▒▒▒▓▒▒▒▒▒▒▒▒▒▒▒▒▒▒▒▒▒▓█▓░▒  ░░    ░░░█▓▒▒▒▒▒▒▓▒▒▒▓▒▒▓▒▒▓▒▒▓▓▒▓▓▓▒▓▓▓▒▓▓▓▒▓▓▓▓▓▓▓▓▓▓▓▓▓▓▓▓▓▓▓▓▓▓▓▓▓▓▓▓▓█▓▓▓▓▓▓▓▓▓▓▓▓▓▒▒▒▒▒▒▒▒▒▒▒▒▓████
████▒▒▒▒▒▒▒▒▓▓▓▓▓▓▓▓▓▓▓▓▓▓▓▓▓▓▓▓▓▓▓▓▓▒▒▒▓▒▒▒▒▒▒▒▒▒▒▒▒▒▒▒▒▒▒▒▒▒▒▒▒▒▒▒▒▒▒▒▒▒▒▒▒▒▒▒▒▒▒▒▒▒▒▒▒▒▒▒▓█▒░░▒    ░░░░██▒▒▒▒▒▒▒▒▒▒▒▒▒▒▒▒▒▒▒▒▒▒▒▒▒▒▒▒▒▒▒▒▒▒▒▒▒▒▒▒▓▒▒▓▒▓▒▓▓▒▓▓▒▓▓▓▓▓▓▓▓▓▓▓█▓▓▓▓▓▓▓▓▓▓▓▒▒▓▒▒▒▒▒▒▒▒▒▒▒▓████
████▒▒▒▒▒▒▒▒▒▒▒▒▓▓▓▓▓▓▓▓▓▓▓▓▓▒▓▒▒▒▒▒▒▒▒▒▒▒▒▒▒▒▒▒▒▒▒▒▒▒▒▒▒▒▒▒▒▒▒▒▒▒▒▒▒▒▒▒▒▒▒▒▒▒▒▒▒▒▒▒▒▒▒▒▒▒▒▒▒▓██▒░░░▒░░▒▓█▓▒▒▒▒▒▒▒▒▒▒▒▒▒▒▒▒▒▒▒▒▒▒▒▒▒▒▒▒▒▒▒▒▒▒▒▒▒▒▒▒▒▒▒▒▒▒▒▒▒▒▒▒▒▒▓▒▓▓▓▓▓▓▓▓▓▒░░███████████████████▒▒▒▒▓████
████▒▒▒▒▒▒▒▒▒▒▒▒▒▒▓▓▓▓▓▓▓▓▓▓▓▒▒▒▒▒▒▒▒▒▒▒▒▒▒▒▒▒▒▒▒▒▒▒▒▒▒▒▒▒▒▒▒▒▒▒▒▒▒▒▒▒▒▒▒▒▒▒▒▒▒▒▒▒▒▒▒▒▒▒▒▒▒▒▒▒▒▒▓███████▓▒▒▒▒▒▒▒▒▒▒▒▒▒▒▒▒▒▒▒▒▒▒▒▒▒▒▒▒▒▒▒▒▒▒▒▒▒▒▒▒▒▒▒▒▒▒▒▒▒▒▒▒▒▒▒▒▒▒▒▒▒▓▓▓▒░▒▒░▒███████████████████▒▒▒▒▓████
████▒▒▒▒▒▒▒▒▒▒▒▒▒▒▒▓▒▓▓▓▓▓▓▓▓▒▒▒▒▒▒▒▒▒▒▒▒▒▒▒▒▒▒▒▒▒▒▒▒▒▒▒▒▒▒▒▒▒▒▒▒▒▒▒▒▒▒▒▒▒▒▒▒▒▒▒▒▒▒▒▒▒▒▒▒▒▒▒▒▒▒▒▒▒▒▒▒▒▒▒▒▒▒▒▒▒▒▒▒▒▒▒▒▒▒▒▒▒▒▒▒▒▒▒▒▒▒▒▒▒▒▒▒▒▒▒▒▒▒▒▒▒▒▒▒▒▒▒▒▒▒▒▒▒▒▒▒▒▒▒▒▒░░▒▒░▒▓█▒███████████████████▒▒▒▒▒████
████▒▒▒▒▒▒▒▒▒▒▒▒▒▒▒▒▒▓▓▓▓▓▓▓▒▒▒▒▒▒▒▒▒▒▒▒▒▒▒▒▒▒▒▒▒▒▒▒▒▒▒▒▒▒▒▒▒▒▒▒▒▒▒▒▒▒▒▒▒▒▒▒▒▒▒▒▒▒▒▒▒▒▒▒▒▒▒▒▒▒▒▒▒▒▒▒▒▒▒▒▒▒▒▒▒▒▒▒▒▒▒▒▒▒▒▒▒▒▒▒▒▒▒▒▒▒▒▒▒▒▒▒▒▒▒▒▒▒▒▒▒▒▒▒▒▒▒▒▒▒▒▒▒▒▒▒▒▒▒░░▒▒░▒█████▒███████████████████▒▒▒▒▒████
████▒▒▒▒▒▓▓▒▒▒▒▒▒▒▒▒▒▒▓▓▓▓▓▓▒▒▒▒▒▒▒▒▒▒▒▒▒▒▒▒▒▒▒▒▒▒▒▒▒▒▒▒▒▒▒▒▒▒▒▒▒▒▒▒▒▓██████████████████████████████████████████████████████████▓▒▒▒▒▒▒▒▒▒▒▒▒▒▒▒▒▒▒▒▒▒▒▒▒▒▒▒▒▒▒▒░▒▒░▒▓█████▓▒▒▒███████████████████▒▒▒▒▒████
████▒▒▒▒▒█▒▒▒▓▓▒▒▒▒▒▒▒▓▓▓▓▓▓▒▒▒▒▒▒▒▒▒▒▒▒▒▒▒▒▒▒▒▒▒▒▒▒▒▒▒▒▒▒▒▒▒▒▒▒▒▒▒▒▒▒▓███▓▓▓█▓▓▓▓▓▓▓█▓▓▓▓▓▓▓▓▓▓▓▓▓▓▓▓▓▓▓▓▓▓▓▓▓▓▓▓▓▓▓▓▓▓▓▓▓▓▓███▒▒▒▒▒▒▒▒▒▒▒▒▒▒▒▒▒▒▒▒▒▒▒▒▒▒▒▒▒▒▒▒▒▒██████▓░▒▒▒▒▒███████████████████▒▒▒▒▒████
████▒▒▒▒▒█▒▒▒▒▒▒▒▓▒▒▒▒▓▓▓▓▓▓▒▒▒▒▒▒▒▒▒▒▒▒▒▒▒▒▒▒▒▒▒▒▒▒▒▒▒▒▒▒▒▒▒▒▒▒▒▒▒▒▒▒▒██▓██████████████████████████████████████████████████▓▓██▒▒▒▒▒▒▒▒▒▒▒▒▒▒▒▒▒▒▒▒▒▒▒▒▒▒▒▒▒▒▒▒████▓▒▓█▓░▒▒▒▒▒███████████████████▒▒▒▒▒████
███▓▒▒▒▒▒█▒▒▒▒▒▒▒▒▒▒▒▒▒▓▓▒▓▓▒▒▒▒▒▒▒▒▒▒▒▒▒▒▒▒▒▒▒▒▒▒▒▒▒▒▒▒▒▒▒▒▒▒▒▒▒▒▒▒▒▒▒██▓█▒                    ░▓█▒                      ░▓▓▓██▒▒▒▒▒▒▒▒▒▒▒▒▒▒▒▒▒▒▒▒▒▒▒▒▒▒▒▒▒▒▒▒████▒▒▓█▓░▒▒▒░▒███████████████████▒▒▒▒▒████
████▒▒▒▒▒█▒▒▒▒▒▒▒▒▒▒▒▒▒▓▒▓▒▒▒▒▒▒▒▒▒▒▓▓██▓█████▓██▓█▓████▓▓▓▓█▓▒▒▒▒▒▒▒▒▒██▓█▒                    ░▓█▒                      ░▓▓▓██▒▒▒▒▒▒▒▒▒▒▒▒▒▒▒▒▒▒▒▒▒▒▒▒▒▒▒▒▒▒▒▒████▒▒▓█▒░▒▓██▒███████████████████▒▒▒▒▒████
███▓▒▒▒▒▒█▒▒▒▒▒▒▒▒▒▒▒▒▒▓▒▒▒▒▒▒▒▒▒▒▒▒▓▒░░░░░░░░░░░░░░░░░░░░░░▒▓▒▒▒▒▒▒▒▒▒██▓█▒                    ░▓█▒                      ░▓▓▒██▒▒▒▒▒▒▒▒▒▒▒▒▒▒▒▒▒▒▒▒▒▒▒▒▒▒▒▒▒▒▒▒███▓▒░▒▓██████▒███████████████████▒▒▒▒▒████
███▓▒▒▒▒▒█▒▒▒▒▒▒▒▒▒▒▒▒▒▓▒▒▒▒▒▒▒▒▒▒▒▒▓▒░░░░░░░░░░░░░░  ░░░░░░▒▓▒▒▒▒▒▒▒▒▒██▓█▒                    ░▓█▒                      ░▓▓▒██▒▒▒▒▒▒▒▒▒▒▒▒▒▒▒▒▒▒▒▒▒▒▒▒▒▒▒▒▒▒▒▒▒▒▒███████████▒███████████████████▒▒▒▒▒████
███▓▒▒▒▒▒█▒▒▒▒▒▒▒▒▒▒▒▒▒▓▒▒▒▒▒▒▒▒▒▒▒▒▓▒░░░░░░░░░░░░░░░░░░░░░░▒▓▒▒▒▒▒▒▒▒▒██▓█▒                     ▓█▒                      ░▓▓▒██▒▒▒▒▒▒▒▒▒▒▒▒▒▒▒▒▒▒▒▒▒▒▒▒▒▒▒▒▒▒▒▒██████████████▒███████████████████▒▒▒▒▒████
███▓▒▒▒▒▒█▒▒▒▒▒▒▒▒▒▒▒▒▒▓▒▒▒▒▒▒▒▒▒▒▒▒▓▓▒▒▒░░░░░░▒▒▒▒▒▒▒▒░░░░░▒▓▒▒▒▒▒▒▒▒▒██▓█▒                    ░▓█▒                      ░▓▓▓██▒▒▒▒▒▒▒▒▒▒▒▒▒▒▒▒▒▒▒▒▒▒▒▒▒▒▒▒▒▒▒▒█████████▓▒░▒▓▒███████████████████▒▒▒▒▒████
███▓▒▒▒▒▒█▒▒▒▒▒▒▒▒▒▒▒▒▒▓▒▒▒▒▒▒▒▒▒▒▒▒▓▓▓▓▒▓▒▒▒▒▒▒▒▒▒▒▒▒▒▒▒▒▒▒▓▓▒▒▒▒▒▒▒▒▒██▓█▒                     ▓█▒                      ░▓▓▒██▒▒▒▒▒▒▒▒▒▒▒▒▒▒▒▒▒▒▒▒▒▒▒▒▒▒▒▒▒▒░▒█████▓▒▒▒░░░▒▒▒███████████████████▒▒▒▒▒████
███▓▒▒▒▒▒█▒▒▒▒▒▒▒▒▒▒▒▒▒▒▒▒▒▒▒▒▒▒▒▒▒▒▓▓▓▓▓▓▓▓▓▓▓▓▓▓▓▓▓▓▓▓▓▓▓▓▓▓░▒▒▒▒▒▒▒▒██▓█▒                    ░▓█▒                      ░▓▓▓██▒▒▒▒▒▒▒▒▒▒▒▒▒▒▒▒▒▒▒▒▒▒▒▒▒▒▒▒▒▒░▒██▒▒▒░░░▒░░▒▓█▒███████████████████▒▒▒▒▒████
███▓▒▒▒▒▒█▒▒▒▒▒▒▒▒▒▒▒▒▒▓▒▒▒▒▒▒▒▒▒▒▒▒▓████████████████████████▓▒▒▒░░▒▒▒▒██▓█▓▓▓▓▓▓▓▓▓▓▓▓▓▓▓▓▓▓▓▓▓▓▓█▓▓▓▓▓▓▓▓▓▓▓▓▓▓▓▓▓▓▓▓▓▓▓▓▓▓▒██▒▒░▒▒▒░▒▒▒▒▒▒▒▒▒▒▒▒▒▒▒▒▒▒▒▒▒▒▒░▒▓▓▒▒▒▒▓███████▒███████████████████▒▒▒▒▒████
███▓▒▒▒▒▒█▒▒▒▒▒▒▒▒▒▒▒▒▒▒▒▒▒▒▒▒▒▒▒▒▒▒▒▒▒▒▒▒▒▒▒▒▒▒▒▒▒▒▒▒▒▒▒▒▒▒░▒▒░▒░▒░░▒▒██▓█▒                    ░▓█▒                      ░▓▓▓██▒▒░░░░▒░░░░░░░▒░▒▒▒▒▒▒▒▒▒▒▒▒▒▒░▒████████▓▓▒░▒▒▒███████████████████▒▒▒▒▒████
███▓▒▒▒▒▒█▒▒▒▒▒▒▒▒▒▒▒▒▒▒▒▒▒▒▒▒▒▒▒▒▒▒▒▒▒▒▒▒▒░▒▒░▒▒░▒░░░░░░░░░░░░░░░░░░░▒██▓█▒                    ░▓█▒                      ░▓▓▒██▒░░░░░░░▒░░▒░░░░░░░░▒░▒░▒▒▒▒▒▒░▒███████▓░▒▒░▒▒▒███████████████████▒▒▒▒▒████
███▓▒▒▒▒▒▓▓▓▓▓▒▒▒▒▒▒▒▒▒▒▒▒▒▒▒▒▒▒▒▒░░░░▒▒░░░▒░░▒░▒░▒░▒░▒░░░░░░░░░░░░░░░▒██▓█▒                    ░▓█▒                      ░▓▓▒██▒░░░░░░░░░░░░░░░░▒░▒░░▒░▒░▒░▒▒░▒███████▒░░▒░▒▒▒███████████████████▒▒▒▒▒████
███▓▒▒▒▒▒▒▒▒▒▒▒▒▒▒▒▒▒▒▒▒▒▒▒▒▒▒▓▓██▓░▒▒▒░░░░░░░░░░░░▒░▒░░░░░░▒░░░░░░░░░▒██▓█▒                     ▓█▒                      ░▓▓▒██▒░░░░░░░░░░░░░░░░░░░▒░░░░░▒░░▒░▒██████▓▒░▒▒░▒▒▒███████████████████▒▒▒▒▒████
███▓▒▒▒▒▒▒▒▒▒▒▒▒▒▒▒▒▒▒▒▓▒▒████████▓▒░░░░▒▒▓▒░░░░░░░░░░░░░░░░░░░░░░░░░░▒██▓█▒                    ░▓█▒                      ░▓▓▒██▒░░░░░░░░░░░░░░░░░░░░░░▒░▒░▒▒▒░▒██████▒▓▒░░░░░░███████████████████▒▒▒▒▒████
████▒▒▒▒▒▒▒▒▒▒▒▒▓█▓░▒▒▒▓██████████▓▒░     ▒▒░░░░░░░░░░░░░░░░░░░░░░░░░░▒██▓█▒                     ▓█▒                      ░▓▓▒██▒░░░░░░░░░░░░░░░░░░░░░░░░░░░░▒░▒▓▓▒▒▒▒▒▒▒▓▓▓██▒███████████████████▒▒▒▒▒████
████▒▒▒▒▒▒▒▒▒▒▒▓██▓░▒▒████████████▓▒░     ▒▒░░░░░░░░░░░░░░░░░░░░░░░░░░▒██▓█▒                    ░▓█▒                      ░▓▓▒██▒░░░░░░░░░░░░░░░░░░░░░░░░▒░▒▒▒░▒██████████████▒███████████████████▒▒▒▒▒████
████▒▒▒▒▒▒▒▒▒▒▒▓██▓░▒▓████████████▓▒▒     ▒▒░▒▒▒▒░▒▒░░░░░░░░░░░░░░░░░░▒██▓█▒         ░    ░░     ▓█▒           ░▒░    ░░▒░░▓▓▒██▒░░░░░░░░░░░░░░░░░░░░░░░░░░░░▒░▒██████████████▒███████████████████▒▒▒▒▒████
████▓▓▓▓█████▓▓▓██▓░▒▓████████████▓▒▒░    ▒▒▒▒▓██▓▒░▒░░░░░░░░░░░░░░░░░▒██▓█▒░░     ░▒▒░  ░▒▒░░░ ░▓█▒          ░▒▒▒▒░▒░░▒▒▒░▓▓▒██▒░░░░░░░░░░░░░░░░░░░░░░░░░▒░░░░▒██▓▓██████████▒███████████████████▒▒▒▒▒████
██████████████████▓▒▒▓▓███████████▓▒▓▒░░░░▒▒▒▓████▓▒░░░░░░░░░░░░░░░░░░▒██▓█▒▒▒░░░░░▒▒▒▒▒░▒▒▒▒▒▒░░▓█▒     ░ ░░░▒▒▒▒▒▒▒▒▒▒▒▒▒▓▓▒██▒░░░░░░░░░░░░░░░░░░░░░░░░░░░▒░░▒█▓▒▓▓▒▒▒▒▒░░░▒▒███████████████████▒▒▒▒▒████
██████████████████▒▓▒▓█████████████▒▒▒▒▒▒▒▒▒▒▓███░▒░░░░░░░░░░░░░░░░░░░▒██▓█▒▒▒▒░▒▒▒▒▒▒▒▒▒▒▒▒▒▒▒▒▒▓█▒░░░░▒▒▒▒▒▒▒▒▒▒▒▒▒▒▒▒▒▒▒▓▓▒██▒░░░░░░░░░░░░░░░░░░░░░░░░░░░░▒░▒█▓▒▒▓░░░▒▒░░░▒▒███████████████████▒▒▒▒▓████
██████████████████▓▓▒█████████████▓▒▒▒▒▒▒▒▒▒▒▒▓█▓░░░░░░░░░░░░░░░░░░░░░▒██▓███▓████▓████████████████▓▓█▓▓███▓██████████████▓█▓▓██▒░░░░░░░░░░░░░░░░░░░░░░░░░▒░░▒░▒█▓▒▒▒░░░▒▒░░░▒▒███████████████████▒▒▒▒▓████
█████████████████████████████████████████▓▒▒▒▒▓▓▓▓▓▒▒▒▒▒▒░░░░░░░░░░░░▒▓██▓█▓█▓▓▓▓█▓█▓▓▓█▓▓▓▓▓▓▓▓█▓█▓█▓█▓█▓█▓▓▓▓█▓▓▓▓▓▓▓▓▓▓██▓▓██▓▒░░░░░░░░░░░░░░░░░░░░░░░▒░▒░▒░▒▓▒▒▒▒░░░░▒░░░▒░███████████████████▒▒▒▒▓████
█████████████████████████████████████████▒▒▒▒▒▒▒▓▓▒▒▒▒▒▒░░░░░░░░░░░░░▒▓█████████████████████████████████████████████████████████▒░░░░░░░░░░░░░░░░░░░▒▒▒▒▒▒▒▓▓▓▓▓▓▒▒░░░░░░    ░░███████████████████▒▓▓▓▓████
████████████████████████████████████████▓▒░░░░ ░    ░░ ░░░▒░░░░░░░░░░░░░░░░░░░░░░░░░░░░░░░░░░░░░░░░░░░░░░░░░░░░░░░░░░░░░░░░░░░░░░░░░░░░░░░░░░░▒░░▒░░░░▒░░░▒███████████████████▒███████████████████▓▓▓▓▓████
████████████████████████████████████████▓░░░▒▒▒▓▓▓▓▓▓██▓▒░░▒░▒▒░▒░▒░▒░▒░░░░░▒░░▒░░░░▒░░░░░░░░░░▒░░░░░░░░░░░░░░░░░░▒░░░░░░▒░░▒░░░▒░▒░▒▒░▒░▒░▒▒▒▒▒▒▒▒▒░░░░░░▒███████████████████▒███████████████████▓▓▓▓▓████
████████████████████████████████████████▓▒▒▒▒▒▒▒▒▒▒▒▓██▓▒▒▒▒▒▒▒▒▒▒▒▒▒▒▒▒▒▒▒▒▒▒▒▒▒▒▒▒░▒▒▒▒▒▒▒▒▒▒▒▒▒▒▒▒▒▒▒▒▒▒▒▒▒▒▒▒▒▒▒▒▒▒▒▒▒▒▒▒▒▒▒▒▒▒▒▒▒▒▒▒▒▒▒▒▒▒▒▒▒▒▒░░▒░░░▒███████████████████▒████████████████████████████
████████████████████████████████████████▓▒▒▒▒▒▒▒   ░▓██▓▒▒▒▒▒▒▒▒▒▒▒▒▒▒▒▒▒▒▒▒▒▒▒▒▒▒▒▒▒▒▒▒▒▒▒▒▒▒▒▒▒▒▒▒▒▒▒▒▒▒▒▒▒▒▒▒▒▒▒▒▒▒▒▒▒▒▒▒▒▒▒▒▒▒▒▒▒▒▒▒▒▒▒▒▒▒▒▒▒▒▒▒▒░░░░▒▒███████████▓░░░░▒▒▒▒████████████████████████████
████████████████████████████████████████▓▒▒▒▒▒▒▒▒  ░▓██▓▒▒▒▒▒▒▒▒▒▒▒▒▒▒▒▒▒▒▒▒▒▒▒▒▒▒▒▒▒▒▒▒▒▒▒▒▒▒▒▒▒▒▒▒▒▒▒▒▒▒▒▒▒▒▒▒▒▒▒▒▒▒▒▒▒▒▒▒▒▒▒▒▒▒▒▒▒▒▒▒▒▒▒▒▒▒▒▒▒▒▒▒▒▒▒▒▒░▒██████████▓▓░░░▒▒▒▒▒████████████████████████████
████████████████████████████████████████▓▒▒▒▒▒▓▒▒  ░▓██▓▒▒▒▒▒▒▒▒▒▒▒▒▒▒▒▒▒▒▒▒▒▒▒▒▒▒▒▒▒▒▒▒▒▒▒▒▒▒▒▒▒▒▒▒▒▒▒▒▒▒▒▒▒▒▒▒▒▒▒▒▒▒▒▒▒▒▒▒▒▒▒▒▒▒▒▒▒▒▒▒▒▒▒▒▒▒▒▒▒▒▒▒▒░░   ▒██████████▓▓▓▒▒▒▒░▒░████████████████████████████
████████████████████████████████████████▓▒▒▒▒▒▓▒▒  ░▓██▓▒▒▒▒▒▒▒▒▒▒▒▒▒▒▒▒▒▒▒▒▒▒▒▒▒▒▒▒▒▒▒▒▒▒▒▒▒▒▒▒▒▒▒▒▒▒▒▒▒▒▒▒▒▒▒▒▒▒▒▒▒▒▒▒▒▒▒▒▒▒▒▒▒▒▒▒▒▒▒▒▒▒▒▒▒▒▒▒▒▒▒▒▒░░░▒░▒██████████▓▓▓▒   ░▒░████████████████████████████
████████████████████████████████████████▓▒▒▒▒▒▒▒   ░▓██▓▒▒▓▓▓▒▓▓▓▒▓▒▓▒▒▒▓▓▒▓▒▓▒▒▓▓▒▒▓▒▒▓▒▒▓▒▓▒▓▓▓▒▓▒▓▒▒▓▒▒▒▓▒▓▒▓▒▒▒▓▒▒▓▒▓▓▒▓▓▓▓▒▓▓▓▒▒▒▒▒▓▒▓▓▒▓▒▓▒▓▓▓▒▒░░  ▒██████████▓▓▒▒░  ░▒▒████████████████████████████
████████████████████████████████████████▓▒▒▒▒▒▒▒  ░░▓██▓▒▓▓▓▓▓▓▓▓▓▓▓▓▓▓▓▓▓▓▓▓▓▓▓▓▓▓▓▓▓▓▓▓▓▓▓▓▓▓▓▓▓▓▓▓▓▓▓▓▓▓▓▓▓▓▓▓▓▓▓▓▓▓▓▓▓▓▓▓▓▓▓▓▓▓▓▓▓▓▓▓▓▓▓▓▓▓▓▓▓▓▓▒░░░▒░▒██████████▓▓▒▒▒░ ░▒░████████████████████████████
████████████████████████████████████████▓▒▒▒▒▒▒▒ ░░▒▒██▓▓███████████████████████████████████████████████████████████████████████████████████████████▓░▒▒░░▒██████████▓▓▒▒▒▒░░▒░████████████████████████████
████████████████████████████████████████▓▒▒▒▒▒▒▒▒▒░▒▓██▓▓███████████████████████████████████████████████████████████████████████████████████████████▓▓███▒▒███████████▓▒░░░░░▒░████████████████████████████
████████████████████████████████████████▓▒▒▒▒▒░▒███████████████████▒░░░░░░▒░░░░░░░░░▒░░░░░░░░▒░░░░░░▒█▓▒▒░░░░░░░▒░░░░░░░░░░░▒░░░░░░░░░▓███████████████████▒████████▓▓▒▒▒▓█▓▒▒▒░████████████████████████████
████████████████████████████████████████▓▒▒▓████████████████████▒░░░░░░▒▒░░░░░░░░░▒▒░░▒░░░░░▒░░░░░░░▒██▒▒░░░░░░░░▒░░░░░░░░░▒░▒▒░░░░░░░░░▒▓█████████████████████████████▓▒░░░▒▒▒████████████████████████████
████████████████████████████████████████▓▓███████████████████▓▒░░░░░░▒▒░░░░░░░░░░▒░░░░░░░░░▒░░░░▒░░░▓██▒▒░░░░░▒░░▒▒░░░░░░░░░▒░░▒░░░░░░░░░░▒▓████████████████████████████████▓▒░███████████████████████▓████
██████████████████████████████████████████████████████████▓░░░░░░░░▒░░░░░░░░░░░░░░░░░░░░░░▒░░░░░░░░░▓██░░░░░░░░░░░▒░░░░░░░░░░░░░░░░░░░░░░░░░░▒▓███████████████████████████████▒████████████████████████████
███████████████████████████████████████████████████████▓░      ░░░           ░▒         ░░         ░▓██░     ░░    ▒        ░  ░░░░░           ░▒▓█████████████████████████████████████████████████████████
████████████████████████████████████████████████████▓▒░░░░░░░░▒▒░░░░░░░░░░░░▒░░░░░░░░░░░▒░░░░░░░░░░▒███▒░░░░░░▒▒░░░▒░░░░░░░░░░░░▒░░▒▒░░░░░░░░░░░░▒▒▒▓██████████████████████████████████████████████████████
█████████████████████████████████████████████████▓▒░░░░░░░░░▒░            ░░          ░▒           ░███░      ░░    ▒         ░  ░░ ░░░            ░░▒▓████████████████████████████████████████████████████
██████████████████████████████████████████████▓▒▒░░░░░░░░▒▒░░░░░░░░░░░░░░▒░░░░░░░░░░░▒▒░░░░░░░░░░░░▒███▒░░░░░░░▒░░░░▒▒░░░░░░░░░▒░░░▒░░▒▒░░░░░░░░░░░░░░▒▒▒▓█████████████████████████████████████████████████
████████████████████████████████████████████▓▓▒▒▒▒▒▒▒▒▒▒▓▒▒▒▒▒▒▒▒▒▒▒▒▒▒▒▓▒▒▒▒▒▒▒▒▒▒▒▒▓▒▒▒▒▒▒▒▒▓▒▒▒▒▓███▓▒▒▒▒▒▒▒▒▒▒▒▒▒▓▒▒▒▒▒▒▒▒▒▒▒▒▒▒▒▒▒▒▓▒▒▒▒▒▒▒▒▒▒▒▒▒▒▒▓▒▓████████████████████████████████████████████████
███████████████████████████████████████████████████████████████████████████████████████████████████████████████████████████████████████████████████████████████████████████████████████████████████████████
███████████████████████████████████████████████████████████████████████████████████████████████████████████████████████████████████████████████████████████████████████████████████████████████████████████