
 ▄▄▄▄▄▄▄▄▄▄▄  ▄▄▄▄▄▄▄▄▄▄▄  ▄▄▄▄▄▄▄▄▄▄▄  ▄▄▄▄▄▄▄▄▄▄▄  ▄▄▄▄▄▄▄▄▄▄▄  ▄▄▄▄▄▄▄▄▄▄▄       ▄▄▄▄▄▄▄▄▄▄▄  ▄         ▄  ▄         ▄  ▄▄▄▄▄▄▄▄▄▄▄  ▄▄▄▄▄▄▄▄▄▄▄      
▐░░░░░░░░░░░▌▐░░░░░░░░░░░▌▐░░░░░░░░░░░▌▐░░░░░░░░░░░▌▐░░░░░░░░░░░▌▐░░░░░░░░░░░▌     ▐░░░░░░░░░░░▌▐░▌       ▐░▌▐░▌       ▐░▌▐░░░░░░░░░░░▌▐░░░░░░░░░░░▌     
▐░█▀▀▀▀▀▀▀▀▀ ▐░█▀▀▀▀▀▀▀▀▀ ▐░█▀▀▀▀▀▀▀▀▀ ▐░█▀▀▀▀▀▀▀█░▌▐░█▀▀▀▀▀▀▀█░▌▐░█▀▀▀▀▀▀▀▀▀      ▐░█▀▀▀▀▀▀▀█░▌▐░▌       ▐░▌▐░▌       ▐░▌▐░█▀▀▀▀▀▀▀▀▀ ▐░█▀▀▀▀▀▀▀█░▌     
▐░▌          ▐░▌          ▐░▌          ▐░▌       ▐░▌▐░▌       ▐░▌▐░▌               ▐░▌       ▐░▌▐░▌       ▐░▌▐░▌       ▐░▌▐░▌          ▐░▌       ▐░▌     
▐░█▄▄▄▄▄▄▄▄▄ ▐░█▄▄▄▄▄▄▄▄▄ ▐░▌          ▐░█▄▄▄▄▄▄▄█░▌▐░█▄▄▄▄▄▄▄█░▌▐░█▄▄▄▄▄▄▄▄▄      ▐░▌       ▐░▌▐░▌   ▄   ▐░▌▐░█▄▄▄▄▄▄▄█░▌▐░█▄▄▄▄▄▄▄▄▄ ▐░▌       ▐░▌     
▐░░░░░░░░░░░▌▐░░░░░░░░░░░▌▐░▌          ▐░░░░░░░░░░░▌▐░░░░░░░░░░░▌▐░░░░░░░░░░░▌     ▐░▌       ▐░▌▐░▌  ▐░▌  ▐░▌▐░░░░░░░░░░░▌▐░░░░░░░░░░░▌▐░▌       ▐░▌     
▐░█▀▀▀▀▀▀▀▀▀  ▀▀▀▀▀▀▀▀▀█░▌▐░▌          ▐░█▀▀▀▀▀▀▀█░▌▐░█▀▀▀▀▀▀▀▀▀ ▐░█▀▀▀▀▀▀▀▀▀      ▐░▌       ▐░▌▐░▌ ▐░▌░▌ ▐░▌▐░█▀▀▀▀▀▀▀█░▌▐░█▀▀▀▀▀▀▀▀▀ ▐░▌       ▐░▌     
▐░▌                    ▐░▌▐░▌          ▐░▌       ▐░▌▐░▌          ▐░▌               ▐░▌       ▐░▌▐░▌▐░▌ ▐░▌▐░▌▐░▌       ▐░▌▐░▌          ▐░▌       ▐░▌     
▐░█▄▄▄▄▄▄▄▄▄  ▄▄▄▄▄▄▄▄▄█░▌▐░█▄▄▄▄▄▄▄▄▄ ▐░▌       ▐░▌▐░▌          ▐░█▄▄▄▄▄▄▄▄▄      ▐░█▄▄▄▄▄▄▄█░▌▐░▌░▌   ▐░▐░▌▐░▌       ▐░▌▐░█▄▄▄▄▄▄▄▄▄ ▐░█▄▄▄▄▄▄▄█░▌     
▐░░░░░░░░░░░▌▐░░░░░░░░░░░▌▐░░░░░░░░░░░▌▐░▌       ▐░▌▐░▌          ▐░░░░░░░░░░░▌     ▐░░░░░░░░░░░▌▐░░▌     ▐░░▌▐░▌       ▐░▌▐░░░░░░░░░░░▌▐░░░░░░░░░░░▌     
 ▀▀▀▀▀▀▀▀▀▀▀  ▀▀▀▀▀▀▀▀▀▀▀  ▀▀▀▀▀▀▀▀▀▀▀  ▀         ▀  ▀            ▀▀▀▀▀▀▀▀▀▀▀       ▀▀▀▀▀▀▀▀▀▀▀  ▀▀       ▀▀  ▀         ▀  ▀▀▀▀▀▀▀▀▀▀▀  ▀▀▀▀▀▀▀▀▀▀▀      
                                                                                                                                                         
