▓▓▓▓▓▓▓███▓▓███▓▓▓▓▓▓▓▓▓▓▓▓▒▒▒▓▓▒▒▒▓▓▒▒▒▓▓▒▒▓▓▒▒▒▒▒▓▓▓▒▒▓█▓▓█████████████▓▓▓▓▓▓▓▓▓████████████████████████████████████████████████▓███████████████████████▓▓▒▒▒▒▒▒▒▓███████████▓▒▒▒▒▒▒▒▒▒▒▒▒▒░▒░▒▒▒▒▒▒▒▒▒▒▒▒▒▒▒▒▒▒░▒░░░░░░░░
▓▓▓▓▓▓█▓▓▓███▓▓▓██▓▓▓▓▓▓▓▓▓▓▓▓▒▒▒▓▓▒▒▓▓▓▒▒▓▓▒▓▒▒▒▒▒▓▓▓▒▒▓█████████████████▓▓▓▓▓▓▓▓▓▓████████████████████████████████████████████▓▓██████████████████████████████████████████▓▒▒▒▒▒▒▒▒▒▒▒▒▒░▒▒▒▒▒▒▒▒▒▒▒▒▒▒▒▒▒▒▒░▒░▒░░░░░░░░░░
▓▓▓▓▓▒▒▒▓██▓▓████▓████▓▓▓▓▓▓▓▓▓▓▒▒▒▓▓▒▒▓▓▓▒▒▓▓▒▒▒▒▒▒█▓▒▒▓█████████████████▓▓▓▓▓▓▓▓▓▓▓████████████████████████████████████████████████████████████████████████████████████▓▒▒▒▒▒▒▒▒▒▒▒▒▒░▒▒▒▒▒▒▒▒▒▒▒▒▒▒▒▒▒░░░░░░░░░░░░░░░░░░░
▓▓▓▓▓▓▓▓▓▒▒▓███▓▓███▓████▓▓████████▒▒▓▓▓▒▒▓▓▒▒▒▒▒▒▒▒█▓▓▒▓█████████████████▓▓▓▓▓▓▓▓▓▓▓▓▓▓████████████████████████████████████████▓▓████████████████████████████████████▓▒▒▒▒▒▒▒▒▒▒▒▒▒░▒▒▒▒▒▒▒▒▒▒▒▒▒▒▒▒▒▒▒░░░░░░░░░░░░░░░░░░░░
▓▓▓▓▓▓█▓▒▒▓▓▒▒▒▓██▓▓███▓█████████████▓▒▒█▓▒▒▓█▓▒▒▒▒▒█▓▓▒▓█████████████████▓▓▓▓▓▓▓▓▓▓▓▓▓▓▓███████████████████████████████████████▓▓▓████████████████████████████████▒▒▒▒▒▒▒▒▒▒▒▒▒▒▒▒▒▒▒▒▒▒▒▒▒▒▒░░░░▒░░░░░░░░░░░░░░░░░░░░░░░░░
▓▓▓▓▓▓▓█▓▓▓▓▒▓▓▓▒▒▓███████████▒▒▒▒▒▒▒▓▓▓▒▒▓▓▒▓▓▒▒▒▒▒█▓▓▓▓█████████████████▓▓▓▓▓▓▓▓▓▓▓▓▓▓▓▓██████████████████████████████████████▓▓██████████████████████████████▒▒▒▒▒▒▒▒▒▒▒▒▒▒▒▒▒▒▒▒▒▒▒▒▒▒░░░░░░░░░░░░░░░░░░░░░░░░░░░░░░░░░░
▓█▓▓▓█▓██▓█▓█▓▓▓▒▓▓▓▒▒▓██████████▒▒▒▒▒▒▒▒▒▒▒▒▓▓▒▒▒▒▒██▓▒▓▓████████████████▓▓▓▓▓▓▓▓▓▓▓▓▓▓▓▓▓█████████████████████████████████████▓▓██████████████████████████▓▒▒▒▒▒▒▒▒▒▒▒▒▒▒▒▒▒▒▒▒▒▒▒▒▒▒░▒░░░░░░░░░░░░░░░░░░░░░░░░░░░░░░░░░░░
█▓▓▓▓████▓█▓█▓▓▓▓▓▓▓▓▓▓▓▒▓██████████▓▒▒▒▒▒▒▒▒▒▓▒▒▒▒▒▓█▓▒▓▓████████████████▓▓▓▓▓▓▓▓▓▓▓▓▓▓▓▓▓▓▓▓▓▓████████████████████████████████▓▓███████████████████████▓▓▒▒▒▒▒▒▒▒▒▒▒▒▒▒▒▒▒▒▒▒▒▒▒▒▒▒░░░░░░░░░░░░░░░░░░░░░░░░░░░░░░░░░░░░░░░
█▓█▓███████▓██▓▓▓█▓▓▓▓▓▓▓▓▓▓▓▓█████████▓▓▓██▒▒▓▒▒▒▒▒▓█▓▓▓▓████████████████▓▒▓▓▓▓▓▓▓▓▓▓▓▓▓▓▓▓▓██████████████████████████▓▓███████▓▓████████████████████▓▓▒▒▒▒▒▒▒▒▒▒▒▒▒▒▒▒▒▒▒▒▒▒░░░░░░░░░░░░░░░░░░░░░░░░░░░░░░░░░░░░░░░░░░░░░░
████████████████▓█▓█▓▓▓▓▓▓▓▒▓▓▓▓▓███████████▓▒▓▒▒▒▒▒▓█▓▓▒▓████████████████▓▓▓▓▓▓▓▓▓▓▓▓▓▓▓▓▓▓▓▓▓██████████████████████▓▓▓▓███████▓██████████████████▓▒▒▒▒▒▒▒▒▒▒▒▒▒▒▒▒▒▒▒▒▒▒▒▒▒░░░░░░░░░░░░░░░░░░░░░░░░░░░░░░░░░░░░░░░░░░░░░░░
███████████████▓███▓█▓████▓█▒▒▒▒▓██▓▓████████▓▓▓▓▒▒▒▒█▓▓▓▓████████████████▓▒▒▓▓▓▓▓▓▓▓▓▓▓▓▓▓▓▓▓█▓████████████████████▓▓▓▓▓███████▓███████████████▓▒▒▒▒▒▒▒▒▒▒▒▒▒▒▒▒▒▒▒▒▒▒▒▒▒░▒░░░░░░░░░░░░░░░░░░░░░░░░░░░░░░░░░░░░░░░░░░░░░░░░
█████████▓████████████▓█▓████▓▒▒▒▒▒▓▓█▓▓████████▓▒▒▒▒█▓▓▓▓█████████████████▓▒▒▓▓▓▓▓▓▓▓▓▓▓▓▓▓▓█▓███████████████████▓▓▓▓▓▓▓███████▓████████████▓▒▒▒▒▒▒▒▒▒▒▒▒▒▒▒▒▒▒▒▒▒▒▒▒▒▒▒▒▒░░░░░░░░░░░░░░░░░░░░░░░░░░░░░░░░░░░░░░░░░░░░░░░░░
██████████▓▓█████████████▓███▓▒▒▒▒▒▒▒▓▒▓██▓████████▓▒█▓▓▓▓▓▓▓▓▓████████████▓▓▒▓▓▓▓▓▓▓▓▓▓▓▓▓▓▓▓▓▓▓▓▓▓██▓██████████▓▓▓▓▓▓▓▓███████▓██████████▒▒▒▒▒▒▒▒▒▒▒▒▒▒▒▒▒▒▒▒▒▒▒▒▒▒▒▒▒▒▒▒▒▒▒▒▒▒▒░░░░░░░░░░░░░░░░░░░░░░░░░░░░░░░░░░░░░░░░░░
█████████▓▓███████████████████▓▒▒▒▒▒▒▓▒▓██▓██▓▓████████▓▓▓█▓▓▓▓████████████▓▓▒▒▓▓▓▓▓▓▓▓▓██████████████▓█████████▓▓▓▓▓▓▓▓▓███████████████▒▒▒▒▒▒▒▒▒▒▒▒▒▒▒▒▒▒▒▒▒▒▒▒▒▒▒▒▒▒▒▒▒▒▒▒▒▒▒░▒░░░░░░░░░░░░░░░░░░░░░░░░░░░░░░░░░░░░░░░░░░░
███████████▓██████████████████▓▒▒▒▒▒▒▒▒▒▒▒▒█▓▒▓██▓█████▓▓▓█▓▓▓▓████████████▓▓▓▓▓▓▓▓▓▓▓▓▓█████████████▓████████▓▓▓▓▓▓▓▓▓▓████████████▓▒▒▒▒▒▒▒▒▒▒▒▒▒▒▒▒▒▒▒▒▒▒▒▒▒▒▒▒▒▒▒▒▒▒▒▒▒▒▒▒▒▒▒░▒░░░░░░░░░░░░░░░░░░░░░░░░░░░░░░░░░░░░░░░░░░
██████████▓▓██████████████████▒▒▒▒▒▒▒▒▓▒▓▒▓▓█▓▒▓▒▒▓████▓▓▓▓█▓▓█████████████▓▓▓▓▓▓▓▓▓▓▓███████████████████████▓▓▓▓▓▓▓▓▓▓▓████████▓▓▒▒▒▒▒▒▒▒▒▒▒▒▒▒▒▒▒▒▒▒▒▒▒▒▒▒▒▒▒▒▒▒▒▒▒▒▒▒▒▒▒▒▒░░░░░░░░░░░░░░░░░░░░░░░░░░░░░░░░░░░░░░░░░░░░░░░
██████████▓███████████████████▓▓▓▒▒▒▒▓▓▓▓▓▓▓█▓▒▓▒▒▒▒███▓▓▓▓▓▓▓▓▓███████████▓▓▓▓▓▓▓▓▓████████████████████████▓▓███▓▓▓▓▓▓▓████████▓▒▒▒▒▒▒▒▒▒▒▒▒▒▒▒▒▒▒▒▒░▒░░░░░░░░░░░░░░░░░░░░░░░░░░░░░░░░░░░░░░░░░░░░░░░░░░░░░░░░░░░░░░░░░░░░░
██████████▓▓██████████████████████▒▒▒████████▓▓▓▒▒▒▒▓██▓▓▓▓▓▓▓▓▓█▓███████████▓▓▓▓▓▓▓▓██████████████████████▓▓▓████▓▓████████████▓▓▒▒▒▒▒▒▒▒▒▒▒▒▒▒▒▒▒▒▒░░░░░░░░░░░░░░░░░░░░░░░░░░░░░░░░░░░░░░░░░░░ ░            ░ ░░░ ░ ░░░░░░
██████████▓▒▓▓████████████████▓▒▒▒▒▒▒▒▒▒▒▓▒▓█▓▒▓▒▒▒▒▓██▓▓▓▓▓▓▓▓▓▓████████████▓▓▓▓▓▓▓▓▓████████████████████▓▓▓█████▓█████████████▓▓▓▒▒▒▒▒▒▒▒▒▒▒▒▒▒▒▒▒░▒░░░░░░░░░░░░░░░░░░░░░░░░░░░░░░░░░░░░░░░░░░░░░░░ ░                     
▓█████████▓▒▒▒▓▓▒▓▓██▓▓█▓▓▓▓██▓▒▒▒▒▒▒▒▒▒▒▓▓▓█▓▒▓▓▒▒▒▓███▓▓▓▓▓▓▓▓▓▓██████████▓▓▓█▓▓▓▓█▓▓▓█████████████████▓▓▓▓▓████▓▓████████████▓▓▓▓▒▒▒▒▒▒▒▒▒▒▒▒▒▒▒▒░▒░░░░░░░░░░░░░░░░░░░░░░░░░░░░░░░░░░░░░░░░ ░░ ░ ░  ░ ░ ░                
▒██████████▒▒▒▒▒▒▒▒▓▓▒▒▓▓▓▓▓▓▓█▓▒▒▒▒▒▒▒▒▒▓▓▓▓▓▓▓▓▒▒▒▒███▓▓▓▓▓▓▓▓▓▓▓█████████████████████████████████████▓██▓▓▓████▓▓█▓▓████████▓▓▓▓▒▒▒▒▒▒▒▒▒▒▒▒▒▒▒▒░▒░░░░░░░░░░░░░░░░░░░░░░░░░░░░░░░░░░░░░░░░░░░░ ░ ░░                      
▒██████████▒▒▒▒▒▒▒▒▒▓▒▓▓▓▓▓▓▓▓▓▓▒▒▒▒▒▒▒▒▓▓▓▓▓▓▓▓▓▒▒▒▒███▓▓▓▓▓▓▓▓▓▓▓▓███████▓▒▒▓▓▓▓██████████████████████▓████▓████▓▓█▓█████████▓▓▓▓▒▒▒▒▒▒▒▒▒▒▒▒▒▒▒▒░▒░░░░░░░░░░░░░░░░░░░░░░░░░░░░░░░░░░░░░░░░░░ ░░ ░ ░ ░   ░                
░▓█████████▓▒▒▒▒▒▒▓▓▒▓▓▓▓▒▓▓▓▓▒▓▒▒▒▒▒▒▒▒▒▓▓▓▓▓▓▓▓▒▒▒▒███▓▓▓▓▓▓▓▓▓▓▓▓▓▓██████▒▒▒▒▓▓████████▒▒▒▒▓▓▓▓▓▓▓▓██▓██▓▓▓███▓▓▓█▓█████████▓▓▓▒▒▒▒▒▒▒▒▒▒▒▒▒▒▒▒▒░▒░░░░░░░░░░░░░░░░░░░░░░░░░░░░░░░░░░░░░░░░ ░░ ░ ░ ░  ░                   
░▓█████████▓▒▒▒▒▒▒▒▓▓▒▒▓▒▒▓▓▒▓▓▓▒▒▒▒▒▒▒▒▒▓▓▓▓▓▓▓▓▒▒▒▒███▓▓▓▓▓▓▓▓▓▓▓▓▓▓██████▓▓▒▓▓▒▒▓██████▒▒▓▓▒▒▓▓▓▓▓▓██▓██▓▓▓███▓▓▓█▓█████████▓▓▓▒▒▒▒▒▒▒▒▒▒▒▒▒▒▒▒░▒░░░░░░░░░░░░░░░░░░░░░░░░░░░░░░░░░░░░░░░░░░░░░ ░ ░ ░   ░                 
▒▒██████████▒▒▒▒▒▒▒▒▒▓▓▓▒▒▓▓▓▓▓▒▓▒▒▒▒▒▒▒▒▒▓▓▓▓▓▓▓▒▒▒▓▓██▓▓▓▓▓▓▓▓▓▓▓▓▓▓██████▓▓▒▓▓▓▓▓██████▒▒▓▓▓▓▓▓▓▓▓███▓██▓▓▓███▓▓▓█▓█████████▓▒▓▒▒▒▒▒▒▒▒▒▒▒▒▒▒▒▒▒▒▒░░░░░░░░░░░░░░░░░░░░░░░░░░░░░░░░░░░░░░░░ ░░░ ░░ ░ ░                    
▒▒██████████▒▒▒▒▒▒▒▒▒▒▒▒▒▒▒▒▒▓▒▒▒▒▒▒▒▒▒▒▒▒▒▒▒▓▓▒▓▓▒▒▓▓██▓▓▓▓▓▓▓▓▓▓▓▓▓▓██████▓▓▒▓▓▒▒▓██████▒▒▒▒▒▒▒▒▒▒▓███▓██▓▓████▓▓▓█▓█████████▓▒▒▒▒▒▒▒▒▓▓▒▒▒▒▒▒▒▒▒▒░▒░░░░░░░░░░░░░░░░░░░░░░░░░░░░░░░░░░░░░░░░░ ░ ░ ░ ░ ░                   
▒░▓█████████▓▒▒▒▒▒▒▒▒▒▒▒▒▒▒▒▒▒▒▒▒▒▒▒▒▒▒▒▒▒▒▒▒▒▒▒▒▓▒▒▒▓██▓▓▓▓▓▓▓▓▓▓▓▓▓▓██████▓▓▒▒▓▒▓▓██████▒▒▒▒▒▒▒▒▓▓▓▓██▓██▓▓████▓▓▓█▓▓████████▓▒▒▒▒▒▒▒▒▓▓▓▓▒▒▒▒▒▒▒▒▒░░░░░░░░░░░░░░░░░░░░░░░░░░░░░░░░░░░░░░░░░░░░ ░ ░                       
▒▒▒█████████▓▒░▒▒▒▒▒▒▒▒▒▒▒▒▓▓▓▓▓▓▓▒▒▒▓▒▒▒▒▒▒▒▒▒▒▒▓▒▒▒▒███▓▒▓▓▓▓▓▓▓▓▓▓▓▓█████▓▓▒▓█▓▒▓██████▓▒▓▒▒▒▒▒▓▓▓███▓██▓▓████▓▓▓█▓█████████▓▒▒▒▒▒▒▒▒▒▒▒▒▒▒▒▒▒▒▒▒▒▒░░░░░░░░░░░░░░░░░░░░░░░░░░░░░░░░░░░░░░ ░ ░ ░ ░ ░ ░                    
▒▒▒██████████▒▒▒▒▒▒▒▒▒░▒▒▒▒▒▒▒▒▒▒▓▓▓▒▓▒▒▒▒▒▒▒▒▒▒▒▓▒▒▒▒███▓▓▓▓▓▓▓▓▓▓▓▓▓▓█████▓▓▒▒▒▒▒▓▓█████▓▒▒▒▒▒▒▒▓▒▒▓██▓██▓▓████▓▓▓█▓█████████▓▒▒▒▒▒▒▒▒▒▒▒▒▒▒▒▒▒▒▒▒▒░░░░░░░░░░░░░░░░░░░░░░░░░░░░░░░░░░░ ░ ░ ░ ░                            
▒▒▒██████████▒▒░▒▒▒▒▒▒▒▒▒▒░░▒▒▒▒▒▒▓▓▓▓▒▒▒▒▒▒▒▒▒▒▒▓▒▒▒▓███▓▓▒▓▓▓▓▓▓▓▓▓▓▓██████▓▒▒▒▒▒▒▓█████▓▒▒▒▒▒▒▒▒▒▒███▓██▓▓██▓█▓▓▓█▓████████▓▓▒▒▒▒▒▒▒▒▓▓▓▓▓▓▒▒▒▒▒▒▒▒▒▒░░░░░░░░░░░░░░░░░░░░░░░░░░░░░░░░░░░░░░░░░░ ░░ ░                     
▒▒▒▓█████████▒▒▒▒▒▒▒▒▒▒▒▒▒▒▒▒▒▒▒▒▒▓▒▓▓▓▒▒▒▒▒▒▒▒▒▒▓▒▒▒▓▓██▓▒▒▓▓▓▓▓▓▓▓▓▓▓██████▓▒▒▒▒▒▒▓█████▓▒▒▒▒▒▒▒▒▒▓██▓▓██▓▓████▓▓▓▓▓▓███████▓▒▒▒▒▒▒▒▒▒▒▓▓▓▓▓▓▒▒▒▒▒▒▒▒▒▒▒░░░░░░░░░░░░░░░░░░░░░░░░░░░░░░░░░░░ ░ ░ ░ ░  ░                    
▒▒▒▒█████████▓▒▒▒▒▒▒▒▒▒▒▒▒▒▒▒▒▒▒▒▒▓▓▓▓▓▒▒▒▒▒▒▒▒▒▓▓▒▒▒▓▓██▓▓▒▓▓▓▓▓▓▓▓▓▓▓██████▓▓▒▒▒▒▒▓█████▓▒▒▒▒▒▒▒▒▒▒█▓▓▓██▓▓█████▓▓▓▓▓███████▓▒▒▒▒▒▒▒▒▒▒▓▓▓▒▓▓▒▓▓▒▒▒▒▒▒▒▒▒░░░░░░░░░░░░░░░░░░░░░░░░░░░░░░░░░░░░░░ ░ ░ ░                     
▒▒▒▒██████████▒▒▒▒▒▒▒▒▒▒▒▒▒▒▒▒▒▒▒▒▓▒▒▓▓▒▒▒▒▓▓▓▓▒▓▓▓▒▒▓▓██▓▒▒▓▒▓▓▓▓▓▓▓▓▓█████▓▓▓▒▓▓▒▓▓█████▓▒▓▓█████▓▒▓▓▓▓████████▓▓▓▓▓▓███████▓▒▒▒▒▒▒▒▒▒▒▓▓▓▓▓▓▓██▓█▒▒▒▒▒▒▒▒░░░░░░░░░░░░░░░░░░░░░░░░░░░░░░░░░░░ ░ ░ ░  ░ ░                  
▒▒▒▒██████████▒▒▒▒▒▒▒▒▒▒▒▒▒▒▒▒▒▒▒▒▒▓▒▒▒▒▒▒▒▒▒▒▒▒▒▒▓▒▒▒▓██▓▒▒▓▓▓▓▓▓▓▓▓▓▓██████▓▓▒▒▓▒█▓███▓█▓▓█████████▓▓▓████▓█████▓▓▓▓████████▓▒▒▒▒▒▒▒▒▒▒▓▓▓▒▓▓▓▓▓▓▓▒▒▒▒▒▒▒▒▒░░░░░░░░░░░░░░░░░░░░░░░░░░░░░░░░░░░░░░ ░                       
▒▒▒▒▓█████████▓▒▒▒▒▒▒▒▒▒▒▒▒▒▒▒▒▒▒▒▓▓▒▒▓▒▒▒▒▒▒▒▒▒▒▒▓▒▒▒▒██▓▒▒▓▓▓▓▓▓▓▓▓▓▓▓█████▓▓▒▓█▒█▓███▓▓▓▓██████████▓▓█████▓▓██▓▓▓█▓▓███████▓▒▒▒▒▒▒▒▒▒▒▒▓▓▒▓▓▒▒▒▒▒▒▒▒▒▒▒▒▒▒▒░░░░░░░░░░░░░░░░░░░░░░░░░░░░░░░░░░░ ░ ░ ░ ░                   
▒▒▒▒▒██████████▒▒▓▒▒▒▓▓▓▓▓▒▒▒▒▒▒▒▒▒▓▒▒▓▒▒▒▒▓▓▓▓▓▓▓▓▒▒▒▓███▒▒▒▓▓▓▓▓▓▓▓▓▓▓█████▓▓▓██▓▓▓██▓▓▓▓████████████▓▓████▒▓▓▓██▓▓▓████████▓▒▒▒▒▒▒▒▒▒▒▒▓▒▒▓▒▒▒▒▒▒▒▒▒▒▒▒▒▒▒▒▒░░░░░░░░░░░░░░░░░░░░░░░░░░░░░░░░ ░░░ ░  ░  ░                 
▒▒▒▒▒██████████▒▒▒▓▓▓▓▒▒▒▒▒▒▒▒▒▒▒▒▒▓▓▓▓▒▒▒▒▓▓▓▓▓▓▓▓▒▒▒▓███▒▒▒▓▓▓▓▓▓▓▓▓▓▓█████▓▓▓█▓▒▓▓██████████████████▓▓▓███▒▓▓▓▓▓██▓████████▓▒▒▒▒▒▒▒▒▒▒▒▒▒▒▒▒▒▒▒▒▒▒▒▒▒▒▒▒▒▒▒▒▒░░░░░░░░░░░░░░░░░░░░░░░░░░░░░░░░░░░ ░ ░                     
▒▒▓▒▒██████████▒▒▒▒▒▒▒▒▒▒▒▒▒▒▒▒▒▒▒▒▒▒▒▒▒▒▒▒▒▓▓▓▓▓▓▓▒▒▒▓▓██▓▒▒▓▓▓▓▓▓▓▓▓▓▓█████▓▓▒▒▓▒▓▓███▓███████████████▓▓▓▓▓▒▓▓▓▓▓▓▓█████████▓▒▒▒▒▒▒▒▒▒▒▒▒▒▒▒▒▒▒▒▒▒▒▒▒▒▒▒▒▒▒▒▒▒░░░░░░░░░░░░░░░░░░░░░░░░░░░░░░░░ ░ ░ ░  ░                   
▒▒▒▒▒▓█████████▓▒▒▓▒░▒▒▓▓▓▓▓▒▒▒▒▒▒▒▒▒▓▓▓▒▒▒▒▓▓▓▓▓▓▓▒▒▒▓▓██▒▒▒▓▓▓▓▓▓▓▓▓▓▓█████▓▓▒▒▓▒▓█▓█▓▓▓██▓▓▓▓▓▓▓▓▓▓█▓▓▓▓▒▒▒▓▓▓▓▓▓▓▓▓▓██████▒▒▒▒▒▒▒▒▒▒▒▒▒▒▒▒▒▒▒▒▒▒▒▒▒▒▒▒▒▒▒▒▒▒░▒░░░░░░░░░░░░░░░░░░░░░░░░░ ░  ░ ░                          
▒▒▓▓▒▒██████████▓▓▓▒▒▒▒▒▒▒▒▒▒▒▒▒▒▒▒▓▓▓▓▓▒▒▒▒▒▒▒▒▒▒▓▒▒▒▓▓██▓▒▒▓▓▓▓▓▓▓▓▓▓▓█████▓▓▒▓▓▒▓▓▓▓▓▓████████████████▓▓▓▒▒▓▓▓▓▓▓▓▓▓▓▓█████▒▒▒▒▒▒▒▒▒▒▒▒▒▒▒▒▒▒▒▒▒▒▒▒▒▒▒▒▒▒▒▒▒▒░░░░░░░░░░░░░░░░░░░░░░░░░░░░░░░░ ░ ░ ░                      
▒▒▒▓▒▒██████████▒▒▒▒▒▒▒▒▒▒▒▒▒▒▒▓▓▓▓▓▓▓▒▒▒▒▒▒▒▒▒▒▒▒▓▓▒▒▒▓██▓▒▒▓▒▒▓▓▓▓▓▓▓▓█████▓▓▒▓▒▓▓▓▓▓▓▓█████████████████▓▓▓▒▓▓▓▓▓▓▓▓▓▓▓▓▓██▓▒▒▒▒▒▒▒▒▒▒▒▒▒▒▒▒▒▒▒▒▒▒▒▒▒▒▒▒▒▒▒▒▒▒▒▒▒░░░░░░░░░░░░░░░░░░░░░░░░ ░ ░ ░      ░ ░ ░                
▒▒▒▒▒▒▓█████████▒▒▒▒▒▒▒▒▒▒▒▒▓▓▓▓▓▓▒▒▒▒▒▒▒▒▒▒▒▒▒▒▒▒▓▓▒▒▒▓██▓▒▒▓▒▓▓▓▓▓▓▓▓▓▓████▓▓▒▒▓▓▓▓▓▓▓███████████████████▓▓▓▓▓▓▓▓▓▓▓▓▓▓▓▓▓▓▓▒▒▒▒▒▒▒▒▒▒▒▒▒▒▒▒▒▒▒▒▒▒▒▒▒▒▒▒▒▒▒▒▒▒▒▒▒▒▒▒▒▒░░░░░░░░░░░░░░░░░░░░░░░░░░░░░░░░░░░░░               
▒▒▒▒▒▒▓█████████▓▒▒▒▒▒▒▓▓▓▒▓▒▒▒▒▒▒▒▒▒▒▒▒▒▒▒▒▒▒▒▒▒▒▒▓▒▒▓███▓▒▒▒▒▒▓▓▓▓▓▓▓▓▓████▓▓▒▓▓▓▓▓▓▓▓███████████████████▓▓▓▓▓▓▓▓▓▓▓▓▓▓▓▓▓▓▓▓▒▒▒▒▒▒▒▒▒▒▒▒▒▒▒▒▒▒▒▒▒▒▒▒▒▒▒▒▒▒▓▓▓▓▓▒▒▒▒▒▒▒▒▒▒▒▒▒▒▒▒▒▒▒▒▒▒░░░░░░░░░░░░░░░░░░░░░               
▒▒▒▒▒▒▒██████████▒▒▒▒▒▒▒▒▒▒▒▒▒▒▒▒▒▒▒▒▒▒▒▒▒▒▒▒▒▒▒▒▒▒▓██▒▒██▓▒▒▒▒▒▓▓▓▓▓▓▓▓▓██████▓▓▓▓▓▓▓▓█████████████████████▓▓▓▓▓▓▓▓▓▓▓▓▓▓▓▓▓▓▓▒▒▒▒▒▒▒▒▒▒▒▒▒▒▒▒▒▒▒▒▒▒▒▒▒▒▒▒▒▒▒▒▒██▒▒▒▒▒▒▒▒▒▒▒▒▒▒▒▒▒▒▒▒▒░▒░░░░░░░░░░░░░░░░░░░                
▒▒▒▒▒▒░██████████▓▓▓▒▒▒▒▒▒▒▒▒▒▒▒▒▒▒▒▒▒▒▒▒▒▒▒▒▒▒▒▒▓████▓██▓▓▒▒▒▒▒▒▓▓▓▓▓▓▓▓█████▓▓▓█▓██▓▓█████████████████████▓▓▓▓▓▓▓▓▓▓▓▓▓▓▓▓▓▓▓▒▒▒▒▒▒▒▒▒▒▒▒▒▒▒▒▒▒▒▒▒▒▒▒▒▒▒▒▒▒▒▒██▓▓▓▓▒▒▒▒▒▒▒▒▒▒▒▒▒▒▒▒▒▒▒░▒░░░░░░░░░░░░░░░░░░                
▒▒▒▒▒▒░▓█████████▓▒▒▒▒▒▒▒▒▒▒▒▒▒▒▒▒▒▒▒▒▒▒▒▒▒▒▒▒▒███████▓▒▒▓▓▒▒▒▒▒▒▓▓▓▓▓▓▓▓█████▓▓▓▓███▓███████████████████████▓▓▓▓▓▓▓▒▓▓▓▓▓▓▓▓▓▓▒▒▒▒▓▒▒▒▒▒▒▒▒▒▒▒▒▒▒▒▒▒▒▒▒▒▒▒▒▒▒▒██▓▓▓▓▓▒▒▒▒▒▒▒▒▒▒▒▒▒▒▒▒▒▒▒▒░░░░░░░░░░░░░░░░░░                
▒▒▒▒▒▒▒▒█████████▓▒▒▒▒▒▒▒▒▒▒▒▒▒▒▒▒▒▒▒▒▒▒▒▓▒▒▓███████▓▒▒▒▒▓▓▒▒▒▒▒▒▒▓▓▓▓▓▓▓████▓▓▓▓▓█▓▓▓████████████████████████▓▓▓▓▓▓▓▒▓▓▓▓▓▓▓▓▓▒▒▒▒▓▒▒▒▒▒▒▒▒▒▒▒▒▒▒▒▒▒▒▒▒▒▒▒▒▒▒▒██▓▓▓▓▓▓▒▒▒▒▒▒▒▒▒▒▒▒▒▒▒▒▒▒░░░░░░░░░░░░░░░░░░░                
▒▒▒▒▒▒▒▒█████████▓▒▒▒▒▒▒▒▒▒▒▒▒▒▒▒▒▒▒▒▒▒▓▒▓████████▓▓▒▒▒▒▒▓▓▒▒▒▒▒▒▒▒▓▓▓▓▓▓████▓▓▓▓▓▓▓▓██████████████████████████▓▓▓▓▓▓▓▓▓▓▓▓▓▓▓▒▒▒▒▒▓▒▒▒▒▒▒▒▒▒▒▒▒▒▒▒▒▒▒▒▒▒▒▒▒▒▒▒██▓▓▓▓▓▓▓▒▒▒▒▒▒▒▒▒▒▒▒▒▒▒▒▒▒▒░░░░░░░░░░░░░░░░                 
▒▒▒▒▒▒▒░▓█████████▒▒▒▒▒▒▒▒▒▒▒▒▒▒▒▒▒▒▒▓▓▓████████▓▒▒▓▒▒▒▒▒▓▓▒▒▒▒▒▒▒▓▓▓▓▓▓▓████▓▓▓▓▓▓▓▓███████████████████████████▓▓▓▓▓▓▓▓▓▓▓▓▓▓▒▒▒▒▒▓▒▒▒▒▒▒▒▒▒▒▒▒▒▒▒▒▒▒▒▒▒▒▒▒▒▒▒██▓▓▓▓▓▓▓▒▒▒▒▒▒▒▒▒▒▒▒▒▒▒░░░░░░░░░░░ ░                        
▒▒▒▒▒▒▓▒▒█████████▒▒▒▒▒▒▒▒▒▒▒▒▒▒▒▒▒▓▓█████████▓▒▒▒▒▒▓▒▒▒▒▓▓▓▒▒▒▒▒▒▒▓▓▓▓▓▓█████▓▓▓▓▓▓▓███████████████████████████▓▓▓▓▓▓▓▓▓▓▓▓▒▓▒▒▒▒▒▒▒▒▒▒▒▒▒▒▒▒▒▒▒▒▒▒▒▒▒▒▒▒▒▒▒▒▒▒▒▒▒▒▒▒▒░░░░░░░░░░░░░░░░░░░░░░░░░░░░░░░░░░░░░░ ░░░░░░░   ░   
▒▒▒▒▒▒▒▒▒█████████▓▒▒▒▒▒▒▒▒▒▒▒▒▒▒▒██████████▓▒▒▒▒▒▒▒▓▒▒▒▒▓▓▓▒▒▒▒▒▒▒▓▓▓▓▓▓█████▓▓▓▓▓▓█████████████████████████████▓▓▓▓▓▓▓▓▓▓▓▓▒▒▒▒▒▒▒▒▒▒▒▒▒▒▒▒▒▒▒▒▒▒▒▒▒▒▒▒▒▒▒▒▒▒▒▒▒░░░░░░░░░▒▒▒▒▒▒░░░░▒▒░░░░░░░░░░░░░░░░░░░░░░░░░░░   ░░░ ░  
▒▒▒▒▒▒▒▒▒▓████████▓▒▒▒▒▒▒▒▒▒▒▒▒▓██████████▓▓▒▒▒▒▒▒▒▒▓▒▒▒▒▒▓▓▒▒▒▒▒▒▒▓▒▓▓▓▓▓████▓▓▓▓▓▓██████████████████████████████▓▓▓▓▓▓▓▓▓▓▒▒▒▒▒▒▒▒▒▒▒▒▒▒▓▓▓▓▓▓▓▓▓▒▒▓███▓▓▓▓▓▒▒▒▓▓▓▓▓▓▓▒▒▓▓▒▒▒▒▒▒▒▒▒▒▒▒▒▒▒▒▒░░░░░░░░░░░░░░░░░░░░░░░░░░░░░░░
▒▒▒▒▒▒▒▒▒▓█████████▒▒▒▒▒▒▒▒▒▒▓█████████▓▓▓▓▓▓▒▒▒▒▒▒▒▓▒▒▒▒▒▓▓▒▒▒▒▒▒▒▒▓▓▓▓▓▓████▓▓▓▓▓███████████████████████████████▓▓▓▓▓▓▓▓▓▓▓▒▒▒▒▒▒▒▓▓█▓▒▒▒████████▓▓████████▓▓▓▓▓▓▓▓▓▓▓▓▓▓▓▒▒▒▒▒▒▒▒▒▒▒▒▒▒▒▒▒▒▒▒▒▒░░░░░░░░░░░░░░░ ░░░░░░░░░ 
▒▒▒▒▒▒▒▒▒▒█████████▒▒▒▒▒▒▒▒████▒▒████▓▓▓▓▓▓▓▓▒▒▒▒▒▒▒▒▒▒▒▒▒▓▓▒▒▒▒▒▒▒▒▒▓▒▓▒▓███▓▓▓▓▓▓█████████████████████████████████▓▓▓▓▓▓▓▓▓▓▒▓█████████████████████▓▒▒▒▓██████▓▓▒▒▒▓▓▓▓▓▓▓▓▓▓▓▓▓▓▒▒▒▒▒▒▒▒▒░░░▒▒▒▒▒▒▒░░░░░░░░░░░░░░░░░░░░░░
▒▒▒▒▒▒▒▒▒▒█████████▓▒▒▒▒██▒░░▒▒████▓▓▓▓▓▓▓▓▓▓▒▒▒▒▒▒▒▓▒▒▒▒▒▓▓▒▒▒▒▒▒▒▒▓▒▓▒▒▓██▓▓▓▓▓▓██████████████████████████████████▓▓▓▓▓▓▓▓▓▓▓▓▓██████████▒▒▒███████████████████▓██▓▓▓▒▓▓▓▓▓▓▓▓▓▒▒░░▒▒▒▒▒▒▒▒▒▒▒▒▒▒▒▒▒▒▒▒░░░░░░░░░░░░░░░░   
▒▒▒▒▒▓▒▓▒▒▓████████▓▒▓████▓░▒████▓▓▒▓▓▓▓▓▓▓▓▓▒▒▒▒▒▒▒▒▒▒▒▒▒▓▓▒▒▒▒▒▒▒▒▒▒▒▓▒▓█▓▓▒▒▓▓▓███████████████████████████████████▓▓▓▓▓▓▒▓▓▓▓▒▒███████████████████████▓▒▒▒▓██████▓▓▓▒▒▒▒▓▓▓▓▓▓▓▓▓▓▓▓▓▓▒▒▒▒▒▒▒▒▒▒░░░▒▒▒▒▒▒░░░░░░░░░░░░░░░░
▒▒▒▒▒▒▒▒▒▒▓████████████████▓▓▓▓▓▒▒▒▓▒▓▓▓▓▓▓▓▓▒▒▒▒▒▒▒▒▒▒▒▒▒▓▓▒▒▒▒▒▒▒▒▒▒▒▒▒▓▓▓▓▒▒▓▓▓███████████████████████████████████▓▓▓▓▓▓▓▒▒▒▓▓▓▒██████████▓▒▒▒▓█████████▓▓██████████▓▓▓█▓▓▓▓▓▓▓▓▓▓▓▓▒▒░░▒▒▒▒▒▒▒▒▒▒▒░░▒▒▒▒▒▒▒░░░░░░░░░░░░░
▒▒▒▒▒▓▓▓▓▒▒█████████████████▓▓▒▒▒▓▓▓▓▓▓▒▓▓▓▓▓▒▒▒▒▒▒▒▒▒▒▒▒▒▓▓▒▒▒▒▒▒▒▒▒▒▒▒▒▓▓▓▒▒▓▓▓█████████████████████████████████████▓▓▓▓▓▓▓▓▓▓▒▒▒▒▓██████████████████████████▓▓▓▓██▓██▓▓▓▓▒▒▒▒▓▓▓▓▓▓▓▓▓▓▒▒▓▓▓▒▒▒▒▒▒▒▒▒▒▒▒▒▒░░▒▒░░░░░░░░░░░
▒▒▒▒▒▓▓▓▓▒▒▓██████████████▓▓▒▒▒▓▓▓▓▓▓▒▓▓▓▓▓▓▓▒▒▒▒▒▒▒▒▒▒▒▒▒▒▓▒▒▒▒▒▒▒▒▒▒▒▒▒▒▓▒▒▒▓▓▓████████████████████████████████████▓█▓▓▓▓▓▓▓▓▓▓▓▓▒▒▓███████████▓▒▒▒██████████▓▒▒▒▓███████▓▓▓▓▓██▓▓▓▓▓▓▓▓▓▓▓▓▓▒▒▒▒▒▒▒▒▒▒▒▒▒▒░░░░░▒▒▒░░░░░░░
▒▒▒▒▓▓▓▓▓▒▒▓████████████▓▓▒▓▒▒▓▓▒▓▓▓▓▓▓▓▓▓▓▓▒▒▒▒▒▒▒▒▒▒▒▒▓▓▓▓▓██▓▒▒▒▒▒▒▒▒▒▒▒▒▒▓▓▓████████████████████████████████████████▓▓▓▓▒▓▓▓▓▓▓▓▒▓▓███████████▓▒▒▓███████████████████▓▓▓▓▓▓▓▓▓▒▒▒▒▓▓▓▓▓▓▓▓▓▓▒▒░░▒▒▒▒▒▒▒▒▒▒▒▒▒▒▒▒▒▒▒▒▒░░░
▒▒▒▒▓▓▓▓▓▓▒▒██████████▓▒▒▒▓▒▓▓▒▓▓▓▓▓▓▓▓▒▒▒▓▒▒▒▒▒▒▒▒▒▒▒▓███▓▓██▓▒▒▒▒▒▒▒▒▒▒▒▒▒▓▓▓▓████████████████████████████████████████▓▓▓▓▓▓▓▒▓▒▒▒▒▓▓▓████████████████████████████▓▒▒▒▒▓███▓▓▓▓▓▓▓▒▒▒▒▓▓▓▓▓▓▓▓▓▓▓▓▓▓▓▓▒▒▒▒▒▒▒▒▒▒▒▒▒░░░░▒▒▒
▒▒▒▒▓▓▓▓▓▓▒▒████████▓▒▓▓▓▓▓▓▒▓▓▓▓▓▓▓▓▓▓▓▒▓▒▒▒▒▒▒▒▒▒▒▒▓███▓▓██▒▒▒▒▒▒▒▒▒▒▒▒▒▒▓▓▓▓██████████████████████████████████████████▓▓▓▓▓▓▓▓▓▓▓▒▓▒▓▓▓████████████▒▒▒▒▓██████████▓▒▒▒▒▓▓▓█▓▓▓▓▓▓▓▓▓▓█▓▓▓▓▓▓▓▓▓▓▓▓▓▓▒░░░▒▒▒▒▒▒▒▒▒▒▒▒░░░░░
▒▒▒▒▓▓▓▓▓▓██████████▓▒▒▒▓▓▓▓▓▓▓▓▓▓▓▓▓▓▓▓▓▒▒▒▒▒▒▒▒▒▒▒████▓▓▓█▓▒▒▒▒▒▒▓▓▓▓▓▓▓▓▓▓▓▓██████████████████████▓████████████████████▓▓▓▓▓▓▓▓▓▓▓▓▓▒▓▓▓████████████▓▒▒▒▒█████████████████▓██▓▓▓▓▓▓▓▓▓▓▒▒▒▒▓▓▓▓▓▓▓▓▓▓▓▒▒░░░▒▒▒▒▒▒▒▒▒▒▒▒▒▒
▒▒▒▒▓▓▒█████████████▓▓▓▓▓▓▓▓▓▓▓▓▓▓▓▓▓▓▓▒▒▒▒▒▒▒▒▒▒▒▓████▒▓██▓▒▒▒▒▒▒▓▓▓▓▓▓▓▓▓▓▓▓██████████████████▓▓█████████████████████████▓▓▓▓▓▓▓▓▓▓▓▓▒▓▓▓▓█████████████████▓████████████▓▓▒▒▒▓█▓▓▓▓▓▓▓▓▓▓▓▒░░▒▒▓▓▓▓▒▓▒▒▒▒▓▒▓▓▓▓▒▒▒▒▒▒▒▒▒▒▒