▓▓▓▓▓▓▓▓▓▓▓▓▓▓▓▓▓▓▓▓▓▓▓▓▓▓▓▓▓▓▓▓▓▓▓▓▓▓▓▓██████████▓▓█▒▒▒▒▒▒▒▒▒▒▓▓▓▓▒▒▒▒▒▓▓▓▓██████████████████████████████████████████████▓██████████████████████████▒▒▒▒▒▒█████████▓▓▓▓▓▓▓▒▒▒▒▓▓▒▓▓▒▒▒░▒▒▒▒▒▒▒▒▒▒▓▓█▓████▓▓▓▒▓▓▓▓▓▓▒▒▒▒▒▒▒▒
▓▓▓▓▓▓▓▓▓▓▓▓▓▓▓▓▓▓▓▓▓▓▓▓▓▓▓▓▓▓▓▓▓▓▓▓▓▓▓▓▓▒▒▒▒▓▓▓▓▓▓▓██▓▓▓▓▓▓▓▓▓▓▓▓▓▒▒▒▒▒▒▓▓▓▓███████████████████████████████████████████████████████████████████████▓▒▒▒▒▒▒██████▓▓▓▓▓▓▓▓▓▓▒▒▒▓▓▓▒▓▓▒▒░▒▒▒▒▒▒▒▒▒▒▒██████▓▓▓▓▒▓▓▓▓▓▒▒▒▒▒▒▒▒▒▒
▓▓▓▓▓▓▓▓▓▓▓▓▓▓▓▓▓▓▓▓▓▓▓▓▓▓▓▓▓▓▓▓▓▓▓▓▓▓▓▓▓▒▒▒▒▒▓▓▓▓▓▓██▓▓▓▓▓▓▓▓▓▓▓▓█▓▓▓▒▒▒▒▓▓▓▓▓▓████████████████████████████████████████████████████████████████████▓▒▒▒▒▒▓██▓▒▓▓▓▓▓▓▓▓▓▒▓▓▒▒▒▓▓▓▓▓▒▒▒▒▒▒▒▒▒▒▒▓▓▓▓▓▓▓▓▓▓▓▓▓▒▒▒▒▒▒▒▒▒▒▒▒▒▒▒▒▒
▓▓▓▓▓▓▓▓▓▓▓▓▓▓▓▓▓▓▓▓▓▓▓▓▓▓▓▓▓▓▓▓▓▓▓▓▓▓▓▓▓▓▒▓▒▒▒▓▓▓▓▓██▓▓▓▓▓▓▓▓▓▓▓▓█▓▓▓▓▒▒▒▒▓▓▓▓▓▓███████████████████████████████████████████████████████████████████▓▒▒▒▒▒▒▒▒▒▒▒▓▓▓▓▓▒▓▓▒▒▒▒▒▓▓▓▓▓▓▒▒▒▒▒▒▒▓▓▓▓▓▓▓▓▓▓▓▓▓▓▒▒▒▒▒▒▒▒▒▒▒▒▒▒▒▒▒▒▒▒
▓▓▓▓▓▓▓▓▓▓▓▓▓▓▓▓▓▓▓▓▓▓▓▓▓▓▓▓▓▓▓▓▓▓▓▓▓▓▓▓▓▓▒▒▒▓▓▓▓▓▓▓██▓▓▓▓▓▓▓▓▓▓▓▓██▓▓▓▒▒▒▒▒▓▓▓▓▓▓▓██████████████████████████████████▓██████████████████████████████▓▒▒▒▒▒▒▒▒▒▒▒▓▓▓▓▒▒▓▒▒▓▒▒▓▒▓▓▒▓▓▒▒▓▓▓▓▓▓▓▓▓▓▓▓▓▒▒▒▒▒▒▒▒▒▒▒▒▒▒▒▒▒▒▒▒▒▒▒▒▒▒
▓▓▓▓▓▓▓▓▓▓▓▓▓▓▓▓▓▓▓▓▓▓▓▓▓▓▓▓▓▓▓▓▓▓▓▓▓▓▓▓▓▓▓█▓▓▒▓▓▓▓▓███▓▓▓▓▓▓▓▓▓▓▓██▓▓▓▓▒▒▒▒▒▓▓▓▓▓▓▓▓▓██████████████████████████████▓██████████████████████████████▓▒▒▒▒▒▒▒▒▒▒▒▓▒▒▓▒▒▓▒▒▒▒▒▓▓▒▓▓▒▓▓▒▒▒▒▒▓▓▓▓▒▒▒▒▒▒▒▒▒▒▒▒▒▒▒▒▒▒▒▒▒▒▒▒▒▒▒▒▒▒▒▒
▓▓▓▓▓▓▓▓▓▓▓▓▓▓▓▓▓▓▓▓▓▓▓▓▓▓▓▓▓▓▓▓▓▓▓▓▓▓▓▓▓▓██████▓▓▓▓▓██▓▓▓▓▓▓▓▓▓▓▓▓█▓▓▓▓▓▒▒▒▒▒▓▓▓▓▓▓▓▓▓▓▓▓█████▓▓▓████████████████▓▓███████████████████████████████▓▒▒▒▒▒▒▒▒▒▒▒▒▒▓▓▒▒▒▒▒▓▒▒▓▓▒▓▓▒▓▒▒▒▒▒▒▒▒▒▒▒▒▒▒▒▒▒▒▒▒▒▒▒▒▒▒▒▒▒▒▒▒▒▒▒▒▒▒▒▒▒▒
▓▓▓▓▓▓▓▓▓▓▓▓▓▓▓▓▓▓▓▓▓▓▓▓▓▓▓▓▓▓▓▓▓▓▓▓▓▓▓▓▓▓▓▓████████▓██▓▓▓▓▓▓▓▓▓▓▓▓█▓▓▓▓▓▓▒▒▒▒▒▒▓▓▓▓▓▓▓▓▓▓▓▓▓███▓███████████████▓▓▓████████████████████████████████▓▒▒▒▒▒▒▒▒▒▒▒▒▒▒▒▒▓▒▒▒▓▓▓▓▓▓▓▒▒▓▒▒▒▒▒▒▒▒▒▒▒▒▒▒▒▒▒▒▒▒▒▒▒▒▒▒▒▒▒▒▒▒▒▒▓▓▓▓▓▒▒▒
▓▓▓▓▓▓▓▓▓▓▓▓▓▓▓▓▓▓▓▓▓▓▓▓▓▓▓▓▓▓▓▓▓▓▓▓▓▓▓▓▓▓▓▓▓▓▓████████▓▓▓▓▓▓▓▓▓▓▓▒█▓▓▓▓▓▓▓▒▒▒░▒▒▒▒▒▒▒▓▓▓▓▓▓▓▓▓▓▓▓▓▓█▓████████▓▓▓▓▓███████████████████████████████▓▒▒▒▒▒▒▒▒▒▒▒▒▒▒▒▒▒▒▒▒▒▓▓▓▓▒▒▓▒▒▓▒▒▒▒▒▒▒▒▒▒▒▒▒▒▒▒▒▒▒▒▒▒▒▒▒▒▒▒▒▒▒▒▒▒▒▒▒▒▒▒▒▒
▓▓▓▓▓▓▓▓▓▓▓▓▓▓▓▓▓▓▓▓▓▓▓▓▓▓▓▓▓▓▓▓▓▓▓▓▓▓▓▓▓▓▓▒▒▒▓▓▓▓███████▓▓▓▓▓▓▒▒▒▒█▓▒▒▒▓▓▒▒▒▒▒▒░░▒▒▒▒▒▒▒▒▒▒▒▒▓▓▓▓▓▓▓▓▓▓▓▓▓▓▓▓▓▓▓▓███████████████████████▓▒▒▓█████▓▒▒▒▒▒▒▒▒▒▒▒▒▒▒▒▓▒▒▒▒▒▓█▓▓▒▒▒▒▓▒▒▒▒▒▒▒▒▒▒▒▒▒▒▒▒▓▓▓▒▒▒▒▒▒▒▒▒▒▒▒▒▒▒▒▒▒▒▒▒▒▒▒
▓▓▓▓▓▓▓▓▓▓▓▓▓▓▓▓▓▓▓▓▓▓▓▓▓▓▓▓▓▓▓▓▓▓▓▓▓▓▓▓▓▓███▒▒▒▓▓▓█▓██████▓▓▓▓▓▓▒▒██▒▒▒▓▓▓▒▒▒▒▒░░░░░░░░▒▒▒▒▒▒▒▒▒▒▒▒▒▒▒▒▒▒▒▒▒▒▓▓▓▓████████████████████▓▒▒▒▒▒██████▓▒▒▒▒▒▒▒▒▒▒▒▒▒▒▓▓▒▒▓▒▒▓▓▓▓▒▓▒▒▓▒▒▒░▒▒▒▒▒▒▒▒▒▒▒▒▒▒▒▒▒▒▒▒▒▒▒▒▒▒▒▒▒▒▒▒▒▒▒▒▒▒▒
▓▓▓▓▓▓▓▓▓▓▓▓▓▓▓▓▓▓▓▓▓▓▓▓▓▓▓▓▓▓▓▓▓▓▓▓▓▓▓▓▓▓▓███▓▓▒▓▓▓▓▓████████▓▓▓▓▓██▓▓▓▓▓▓▒▒▒▒▒░░░░░░░░▒▒▒▒▒▒▒▒▒▒▒▒▒▒▒▒▒▒▒▒▒▒▒▓▓▓█████████████████▓▒▒▒▒▒▒▒▒▓█████▓▒▒▒▒▒▒▒▒▒▒▒▒▒▒▓▒▒▓▓▓▒▒▓▓▓▓▒▒▒▒▒▒░▒▒▒▒▒▒▒▒▒▒▒▒▓▒▒▒▒▒▒▒▒▒▒▒▒▒▒▒▒▒▒▒▒▒▒▒▒▒▒▒
▓▓▓▓▓▓▓▓▓▓▓▓▓▓▓▓▓▓▓▓▓▓▓▓▓▓▓▓▓▓▓▓▓▓▓▓▓▓▓▓▓▓▓▓▓▒▒▒░▓▓▓▓▓██▓▓▓██████▓▓▓█▒▓▓▓▓▓▓▒▒▒▒░░░░░░▒▒▒▒▒▒▒▒▒▒▒▒▒▒▒▒▒▒▒▒▒▒▒▒▒▓▓▓██████████████▒▒▒▒▒▒▒▒▒▒▓▓▓█████▓▒▒▒▒▒▒▒▒▒▒▒▒▒▒▒▒▒▒▒▒▒██▓▒▓▒▒▒▒▒▒▒▒▒▒▒▒▒▒▒▒▒▒▒▒▓▒▒▒▒▒▒▒▒▒▒▒▒▒▒▒▒▒▒▒▒▒▒▒▒▒▒
▓▓▓▓▓▓▓▓▓▓▓▓▓▓▓▓▓▓▓▓▓▓▓▓▓▓▓▓▓▓▓▓▓▓▓▓▓▓▓▓▓▓▓▓▒░░░░▒▓▓▓▓██▓▓▓▓▓▓███████▒▒▒▒▓█░▒▒▒▒░░░░░░░▒▒▒▒▒▒▒▒▒▒▒▒▒▒▒▒▒▒▒▒▒▒▒▒▓▓█████████████▒▒▒▒▒▒▒▒▓▓▓▒▒▓▓█████▓▒▒▒▒▒▒▒▒▒▒▒▒▒▒▓▓▒▒▒▒▒▓▓▓▒▒▒▒▒▒▒▒▒▒▒▒▒▒▒▒▒▒▒▒▒▒▓▒▒▒▒▒▒▒▒▒▒▒▒▒▒▒▒▒▒▒▒▒▒▒▒▒▒
▓▓▓▓▓▓▓▓▓▓▓▓▓▓▓▓▓▓▓▓▓▓▓▓▓▓▓▓▓▓▓▓▓▓▓▓▓▓▓▓▓▓▓▓▒▒░░▒▒▓▓▓█▓██▓▓▓▓▓▓▓▒█████▒▒▒▓█▒▒▒▒▒▒░░░░░░▒▒▒▒▒▒▒▒▒▒▒▒▒▒▒▒▒▒▒▒▒▒▒▒▓▓████████████▓▒▒▒▓▓▓▓▒▒▒▒▒▒▓██████▒▒▒▒▒▒▒▒▒▒▒▒▒▒▒▒▒▒▒▒▒▓█▓▓▒▒▒▒▒▒▒▒▒▒▒▒▒▒▒▒▒▒▒▒▒▒▒▒▒▒▒▒▒▒▒▒▒▒▒▒▒▒▒▒▒▒▒▒▒▒▒▒▒
▓▓▓▓▓▓▓▓▓▓▓▓▓▓▓▓▓▓▓▓▓▓▓▓▓▓▓▓▓▓▓▓▓▓▓▓▓▓▓▓▓▓▓▓████▓█▓▓▓▓▓██▓▓▓▓▓▓▓▒▒▓▓███████▒▒▒▒▒▒░░░░░░▒▒▒▒▒▒▒▒▒▒▒▒▒▒▒▒▒▒▒▒▒▒▒▒▓▓████████████▓▒▒▓▓████▓▒▒▒▒▓█████▓▒▒▒▒▒▒▒▒▒▒▒▒▒▒▒▒▒▒▒▒▒▓▓▓▓▒▒▒▒▒▒▒▒▒▒▒▒▒▒▒▒▒▒▒▒▒▒▒▒▒▒▒▒▒▒▒▒▒▒▒▒▒▒▒▒▒▒▒▒▒▒▒▒▒
▓▓▓▓▓▓▓▓▓▓▓▓▓▓▓▓▓▓▓▓▓▓▓▓▓▓▓▓▓▓▓▓▓▓▓▓▓▓▓▓▓▓▓▓▓▒░▒▓▓█▓▓▓▓██▓▓▓▓▓▓▓▓▒▓▓█▓▒▒███▓▒▓▓▒▒░░░░░░▒▒▒▒▒▒▒▒▒▒▒▒▒▒▒▒▒▒▒▒▒▒▒▒▓▓▓█▓▓████████▓▒▒▓▓████▓▓█▓▒▓█████▓▒▒▒▒▒▒▒▒▒▒▒▒▒▒▒▒▓▓▓▓▓▓▓▓▓▓▒▒▒▒▒▒░▒▒▒▒▒▒▒▒▒▒▒▒▒▒▒▒▒▒▒▒▒▒▒▒▒▒▒▒▒▒▒▒▒▒▒▒▒▒▒▒▒
▓▓▓▓▓▓▓▓▓▓▓▓▓▓▓▓▓▓▓▓▓▓▓▓▓▓▓▓▓▓▓▓▓▓▓▓▓▓▓▓▓▓▓▓▓▒▒▒▒▓▓▓█▓▓██▓▓▓▓▓▓▓▓▒▓▓██░░▒▒▓█▓▓▓▓▒░░░░░░░░░░░░░▒▒▒▒▒▒▒▒▒▒▒▒▒▒▒▒▒▓▓▓▓██████████▓▒▒▓▓████▓▓▓▓▓▓█████▓▒▒▒▒▒▒▒▒▒▒▓▒▓▒▓▒▒▒▒▒▒▒▓▓▒▒▒▒▒▒▒▒░▒▒▒▒▒▒▒▒▒▒▒▒▒▒▒▒▒▒▒▒▒▒▒▒▒▒▒▒▒▒▒▒▒▒▒▒▒▒▒▒▒
▓▓▓▓▓▓▓▓▓▓▓▓▓▓▓▓▓▓▓▓▓▓▓▓▓▓▓▓▓▓▓▓▓▓▓▓▓▓▓▓▓▓▓▓▓▒▒▒▓▓▓██▓█▓██▓▓▓▓▓▓▓▓▓▓▓█▒▒▒▓█▓▒▒▒▒▒░░▒░░░▒░░░░░░░░░▒▒▒▒▒▒▒▓▓▓▓▒▒▒▒▒▒▓█████▓████▓▒▒▓▓█████▓▓▓▓▓█████▓▒▒▒▒▒▒▒▒▒▒▒▒▒▒▒▒▒▒▒▒▒▒▓▓▒▒▒▒▒▒▒▒▒▒▒▒▒▒▒▒▒▒▒▒▒▒▒▒▒▒▒▒▒▒▒▒▒▒▒▒▒▒▒▒▒▒▒▒▒▒▒▒▒▒
▓█▓▓▓▓▓▓▓▓▓▓▓▓▓▓▓▓▓▓▓▓▓▓▓▓▓▓▓▓▓▓▓▓▓▓▓▓▓▓▓▓▓▓▓▓▓▒▓▒▓█▓█▓▓██▒▒▒▒▓▓▓▒▓▓▓█░░░▓██▒▓▓▒▒░░▒░░░▒░░░░░░░░░░░▒▒▒▒▒▒▒▓▒▒▒▒▒▒▒▒██████████▓▒▒▓▓████▓▓▓▓▓▓█████▓▒▒▒▒▒▒▒▒▒▒▒▒▒▒▒▒▒▒▒▒▒▒▓▒▒▒▒▒▒▒▒▒▒▒▒▒▒▒▒▒▒▒▒▒▒▒▒▒▒▒▒▒▒▒▒▒▒▒▒▒▒▒▒▒▒▒▒▒▒▒▒▒▒▒
█▓▓▓▓▓▓▓▓▓▓▓▓▓▓▓▓▓▓▓▓▓▓▓▓▓▓▓▓▓▓▓▓▓▓▓▓▓▓▓▓▓▓▓▓▓▒▒▒▒▓███▓▓██▓▓▓▓▓▓▓▒▓▓▓█▒░▒▓██▒▒▓▓▒░░▒░░░▒░░░░░░░░░░░░░░░░░▒▒▒░▒▒▒▒▓▓▓█████████▒▒▒█▓████▓▓▓▓▓██████▒▒▒▒▒▒▒▒▒▒▒▒▒▒▒▒▒▒▒▒▒▒▒▓▒▒▒▒▒▒▒▒░▒▒▒▒▒▒▒▒▒▒▒▒▒▒▒▒▒▒▒▒▒▒▒▒▒▒▒▒▒▒▒▒▒▒▒▒▒▒▒▒▒▒
██▓▓▓▓▓▓▓▓▓▓▓▓▓▓▓▓▓▓▓▓▓▓▓▓▓▓▓▓▓▓▓▓▓▓▓▓▓▓▓▓▓▓▓▓▓▓▓▓▓███▓███▓▓▓▒▒▓▓▒▓▓▓█▒░░▒██▒▒▓▓▒▒░▒▒░░▒░░░░░   ░░░░░▒▒▒▒▒▒▒▒▒▒▒▓█▓▓█████████▒▒▓▓▓████████▓██████▒▒▒▒▒▒▒▒▒▒▒▒▓▓▓▓▓▓▓▓▓▒▒▓▒▒▒▒▒▒▒▒▒▒▒▒▒▒▒▒▒▒▒▒▒▒▒▒▒▒▒▒▒▒▒▒▒▒▒▒▒▒▒▒▒▒▒▓▓▓▓▒▒▒▒
███▓▓▓▓▓▓▓▓▓▓▓▓▓▓▓▓▓▓▓▓▓▓▓▓▓▓▓▓▓▓▓▓▓▓▓▓▓▓▓▓▓▓▓▒▒▒▒▒▓██▓█▓██▓▓▒▒▓▓▓▒▓▓█▓▒░▒██▒▒▓▓▓▒▒▒▒░░▒░░░░░░░░░░░░▒▒▒░▒▒▒▒▒▒▒▓▓▓▓▓█████████▓▒▓▓████▓▓█▓███████▓▒▒▒▒▓▓▓▓▓▒▒▒▒▒▒▒▒▒▒▒▒▒▒▒▒▒▒▒▒▒▒▒▒▒▒▒▒▒▒▒▒▒▒▒▒▒▒▒▒▒▒▒▒▒▒▒▒▒▒▒▒▒▒▒▒▒▒▒▒▒▒▒▒▒▒
██▓▓▓▓▓▓▓▓▓▓▓▓▓▓▓▓▓▓▓▓▓▓▓▓▓▓▓▓▓▓▓▓▓▓▓▓▓▓▓▓▓▓▓▓▓░░▒▒▒▓██▓▓██▓▓▓▓▓▓▓▒▓▓▓█▒▒▒██▓▒▓▓▓▒▒▒▒░░▒▒░░░░░░░░░░░▒▒▒▒▒▒▒▒▒░▒▒▒▓▓██████████▓▒▓▓███████▓▓██████▓▒▒▒░░▒▒▒▒▒▒▒▒▒▒▒▒▒▒▒▒▒▒▒▒▒▒▒░░░▒▒▒▒▒▒▒▒▒▒▒▒▒▒▒▒▒▒▒▒▒▒▒▒▒▒▒▒▒▒▒▒▒▒▒▒▒▒▒▒▒▒▒▒
▓▓█▓▓▓▓▓▓▓▓▓▓▓▓▓▓▓▓▓▓▓▓▓▓▓▓▓▓▓▓▓▓▓▓▓▓▓▓▓▓▓▓▓▓▓▓░░░░▒▓██▓▓██▓▓▓▓▓█▓▓██▓█▒▒▒██▓▒▓▓▓▒▒▒▒░░▒▒░░░░  ░░░▒░▒▒▒▒▒▓█▓▒▒▓▒▒▒▓██████████▒▒▓▓█████████▓█████▓▒▒▒▒▒▒▒▒▒▒▒▒▒▒▒▒▒▒▒▒▒▒▒▒▒▒▒▒▒░░▒▒▒▒▒▒▒▒▒▒▒▒▒▒▒▒▒▒▒▒▒▒▒▒▒▒▒▒▒▒▒▒▒▒▒▒▒▒▒▒▒▒▒▒
███▓▓▓▓▓▓▓▓▓▓▓▓▓▓▓▓▓▓▓▓▓▓▓▓▓▓▓▓▓▓▓▓▓▓▓▓▓▓▓▓▓▓▓▓▒░░░░▓██▓███▒▒▒▓▓▓▓▓████▒▒▒▓█▓▒▓▓▓▒▒▒▒░░▒░░░░░░░░░░░░▒▒▒▒░░░ ░▒▓▒▒▒▓█▓▓███████▒▒▓▓████▓████▓█████▓▒▒▒▒▒▒▒▒▒▒▒▒▒▒▒▒▒▒▒▒▒▒▒▒▒▒▒▒▒░░▒▒▒▒▒▒▒▒▒▒▒▒▒▒▒▒▒▒▒▒▒▒▒▒▒▒▒▒▒▒▒▒▒▒▒▒▒▒▒▒▒▒▒▒
████▓▓▓▓▓▓▓▓▓▓▓▓▓▓▓▓▓▓▓▓▓▓▓▓▓▓▓▓▓▓▓▓▓▓▓▓▓▓▓▓▓▓▓▓░░░░▒▓█▓▓██▓▒▒▒▒▓▓▒▒▓▓▓▒░░▓▓█▒▓▓▓▒▒░▒░░▒░░░░░░░░░░░░░▒░░   ░░▒▓▒▓▓▒▓▓▒▓▒████▓▒▒▓▓████▓█▓▓▓▓█████▒▒▒▒▒▒▒▒▒▒▒▒▒▒▒▒▒▒▒▒▒▒▒▒▒▒▒▒▒▒▒▒▒▒▒▒▒▒▒▒▒▒▒▒▒▒▒▒▒▒▒▒▒▒▒▒▒▒▒▒▒▒▒▒▒▒▒▒▒▒▒▒▒▒▒▒
▓████▓▓▓▓▓▓▓▓▓▓▓▓▓▓▓▓▓▓▓▓▓▓▓▓▓▓▓▓▓▓▓▓▓▓▓▓▓▓▓▓▓▓▓░░▒▒▒▓██▓██▓▒▒▒▒▒░▒▒▓▓▓▒  ▒▓▓░▒▓▓▒▒░▒░░▒░░░░░░░░░░    ░ ░░ ░░▒▓▒▒█▓▓▓▓▓▒████▓▒▒▓▓▓▓▓▓▓█▓▒▓▓█████▒▒▒▒▒▒▒▒▒▒▒▒▒▒▒▒▒▒▒▒▒▒▒▒▒▒▒▒▒▒▒▒▒▒▒▒▒▒▒▒▒▒▒▒▒▒▒▒▒▒▒▒▒▒▒▒▒▒▒▒▒▒▒▒▒▒▒▒▒▒▒▒▒▒▒▒
██████▓▓▓▓▓▓▓▓▓▓▓▓▓▓▓▓▓▓▓▓▓▓▓▓▓▓▓▓▓▓▓▓▓▓▓▓▓▓▓▓▓▓█████▓▓█▓██▓▒▒▒▒▒▒▒▒▓▓▓▒░░▒▓▓▒▒▓▓▒▒░▒░░░░░░░░░░░░░     ░  ░░░▒▓▓▒▒▓█▒▒▓▒████▓▒▒▓▓▓▓▓▓▓▓▓▓▓██████▒▒▒▒▒▒▒▒▒▒▒▒▒▒▒▒▒▒▒▒▒▒▒▒▒▒▒▒▒▒░░▒▒▒▒▒▒▒▒▒▒▒▒▒▒▒▒▒▒▒▒▒▒▒▒▒▒▒▒▒▒▒▒▒▒▒▒▒▒▒▒▒▒▒▒
█████▓█▓▓▓▓▓▓▓▓▓▓▓▓▓▓▓▓▓▓▓▓▓▓▓▓▓▓▓▓▓▓▓▓▓▓▓▓▓▓▓▓▓█▓▓▓▓▓▓▓▓██▓▒▒▒▒▒▒▒▒▓▓▓▓░░░▓▓▓▓▓▓▒▒░░░░░     ░░░░     ░░░ ░░░▒▓██▒▒█▒▒█▒████▒▒▒▓▓▓▓▓▓▒▒▒▒▓█████▓▒▒▒▒▒▒▒▒▒▒▒▒▒▒▒▒▒▒▒▒▒▒▒▒▒▒▒▒▒▒▒░▒▒▒▒▒▒▒▒▒▒▒▒▒▒▒▒▒▒▒▒▒▒▒▒▒▒▒▒▒▒▒▒▒▒▒▒▒▒▒▒▒▒▒▒
█████▓█▓▓▓▓▓▓▓▓▓▓▓▓▓▓▓▓▓▓▓▓▓▓▓▓▓▓▓▓▓▓▓▓▓▓▓▓▓▓▓▓▓▓▒▒▒▒▒▓▓▓▓██▒▒▒▒▒▒▒▒▓▓█▓░ ░▓█▓▓▓▓▓▒░░░░░ ░░░░░░░░░░░░░░░░░░░▒▒▒▒▓▒▒▓▓▒██████▒▒▒▓▓▓▓▓▒▒▒▒▓▓█████▓▒▒▒▒▒▒▒▒▒▒▒▒▒▒▒▒▒▒▒▒▒▒▒▒▒▒▒▒░▒░▒▒▒▒▒▒▒▒▒▒▒▒▒▒▒▒▒▒▒▒▒▒▒▒▒▒▒▒▒▒▒▒▒▒▒▒▒▒▒▒▒▒▒▒▒
███████▓▓▓▓▓▓▓▓▓▓▓▓▓▓▓▓▓▓▓▓▓▓▓▓▓▓▓▓▓▓▓▓▓▓▓▓▓▓▓▓▓▓▒▒▒▒▒▓▓█▓██▒▒▒▒▒▒▒▒▒▓▓▓░░▓█▓▒▒▓▓▓▒░░░░░░░░░░░░░░░░░░░░░░░░░▓██▒▒▒▒████▓████▒▒▒▓▓▓▓▓▒▒▒▒▓▓█████▓▒▒▒▒▒▒▒▒▒▒▒▒▒▒▒▒▒▒▒▒▒▒▒▒▒▒▒▒▒░░░▒▒▒▒▒▒▒▒▒▒▒▒▒▒▒▒▒▒▒▒▒▒▒▒▒▒▒▒▒▒▒▒▒▒▒▒▒▒▒▒▒▒▒▒
████▓▓▓▓▓▓▓▓▓▓▓▓▓▓▓▓▓▓▓▓▓▓▓▓▓▓▓▓▓▓▓▓▓▓▓▓▓▓▓▓▓▓▓▓▓▓▒▒▒▒▓▓▓▓██▒▒▒▒▒▒▒▒▒▓▓███▒▒▓▓░▒▓▓▒░░░░░░░░░░░░░░░░░░░░░░░░░▓████▓▒▒████████▒▒▒▓▓▓▓▓▒▒▒▒▓▓█████▓▒▒▒▒▒▒▒▒▒▒▒▒▒▒▒▒▒▒▒▒▒▒▒▒▒▒▒▒▒▒▒▒▒▒▒▒▒▒▒▒▒▒▒▒▒▒▒▒▒▒▒▒▒▒▒▒▒▒▒▒▒▒▒▒▒▒▒▒▒▒▒▒▒▒▒▒
█████▓▓▓▓▓▓▓▓▓▓▓▓▓▓▓▓▓▓▓▓▓▓▓▓▓▓▓▓▓▓▓▓▓▓▓▓▓▓▓▓▓▓▓▓▓▒▒▒▒▒▓▓▓██▒▒▒▒▒▒▒░▒███▓▒▒▒▓▓▒▒▓▓▒░░░░░░░░░░░░░░░░░░░░░░░░░▓███████▒▒▓█████▒▒▒▓█▓▓▓▒▒▓██▓█████▒▒▒▒▒▒▒▒▒▒▒▒▒▒▒▒▒▒▒▒▒▒▒▒▒▒▒▒▒▒░▒▒▒▒▒▒▒▒▒▒▒▒▒▒▒▒▒▒▒▒▒▒▒▒▒▒▒▒▒▒▒▒▒▒▒▒▒▒▒▒▒▒▒▒▒▒
██████▓▓▓▓▓▓▓▓▓▓▓▓▓▓▓▓▓▓▓▓▓▓▓▓▓▓▓▓▓▓▓▓▓▓▓▓▓▓▓▓▓▓▓▓▒▒▒▒▒▓█▓▓█▓▒░▒░▒▒▓███▓▒░░▒▓▓▒▒▓▓▒░░░░░░░░░░░░░░░░░░░░░░░░░▒▓███████▒▓▓▓███▒▒▒▓▓▓▒▒▓▓█████████▒▒▒▒▒▒▒▒▒▒▒▒▒▒▒▒▒▒▒▒▒▒▒▒▒▒▒▒▒▒▒░▒▒▒▒▒▒▒▒▒▒▒▒▒▒▒▒▒▒▒▒▒▒▒▒▒▒▒▒▒▒▒▒▒▒▒▒▒▒▒▒▒▒▒▒▒
███▓█▓█▓█▓▓▓▓▓▓▓▓▓▓▓▓▓▓▓▓▓▓▓▓▓▓▓▓▓▓▓▓▓▓▓▓▓▓▓▓▓▓▓▓▓▒▒▒▒▒▓█▓▓██▒▒▒▒▓██▓▓▓█▓░░▒▓▓▒▒▓▒▒░░░░░░░░░░░░░░░░░░░░░░░░░▒▒█████▓█░▒▓▓▓▓▓▒▒▒▓▓▓▓▓▒▒▓▓▓██████▒▒▒▒▒▒▒▒▒▒▒▒▒▒▒▒▒▒▒▒▒▒▒▒▒▒▒▒▒░░▒░▒▒▒▒▒▒▒▒▒▒▒▒▒▒▒▒▒▒▒▒▒▒▒▒▒▒▒▒▒▒▒▒▒▒▒▒▒▒▒▒▒▒▒▒
████▓███▓▓▓▓▓▓▓▓▓▓▓▓▓▓▓▓▓▓▓▓▓▓▓▓▓▓▓▓▓▓▓▓▓▓▓▓▓▓▓▓▓▓▒▒▒▒▒▒█▓▓██▒▒███▓▒▒▒▓█▓▒▒▒▓▓▒▓▒▒░░░░▒▒▒▓▓▓▓▓▓██████████▒▒▒▒░▒████▓█░▒▓▓▓▓▓▒▒▒▓▓██▓▓▓▓▓▓█████▓▒▒▒▒▒▒▒▒▒▒▒▒▒▒▒▒▒▒▒▒▒▒▒▒▒▒▒▒▒░▒▒▒▒▒▒▒▒▒▒▒▒▒▒▒▒▒▒▒▒▒▒▒▒▒▒▒▒▒▒▒▒▒▒▒▒▒▒▒▒▒▒▒▒▒▒▒
▓█████▓▓▓▓▓▓▓▓▓▓▓▓▓▓▓▓▓▓▓▓▓▓▓▓▓▓▓▓▓▓▓▓▓▓▓▓▓▓▓▓▓▓▓▓▓▒▒▒▒▓███▓█████▓▓▓▓▓██▓▒▒▒██▓▒▒▒▒▒▒▒▒▒▓█████████████████▒▒▒▒▒▒▓██▓▓░▒▓▓▓▓▓▒▒▒▓▓███▓█▓▓▓█████▓▒▒▒▒▒▒▒▒▒▒▒▒▓▒▒▒▒▒▒▒▒▒▒▒▒▒▒▒░░▒▒▒▒▒▒▒▒▒▒▒▒▒▒▒▒▒▒▒▒▒▒▒▒▒▒▒▒▒▒▒▒▒▒▒▒▒▒▒▒▒▒▒▒▒▒▒
████████▓▓▓▓▓▓▓▓▓▓▓▓▓▓▓▓▓▓▓▓▓▓▓▓▓▓▓▓▓▓▓▓▓▓▓▓▓▓▓▓▓▓▓▒▒▒▒▒███████▓▓▓▓▓▓▓██▓▒▒▒▓█▓▓▒▒▒▒▒▒▒▒███████████████████▓▒▒▒▒░▒█▓▓░▒▓▓▓▓▒▒▒▒▓▓███▓██▓▓█████▓▒▒▒▒▒▒▒▒▒▒▒▒▒▒▒▒▒▒▒▒▒▒▒▒▒▒▒▒▒░▒▒▒▒▒▒▒▒▒▒▒▒▒▒▒▒▒▒▒▒▒▒▒▒▒▒▒▒▒▒▒▒▒▒▒▒▒▒▒▒▒▒▒▒▒▒▒
██▓▓███▓▓▓▓▓▓▓▓▓▓▓▓▓▓▓▓▓▓▓▓▓▓▓▓▓▓▓▓▓▓▓▓▓▓▓▓▓▓▓▓▓▓▓▓▓▒▒▓██▓▓███▓▓▓▓▓▓▓▓█▓▓▒▒▒▓▓▒▒▒▒▒▒▒▒▒▓████████████████████▓▓▓▒▒▒▒▒▒▒▒▒▒▓▓▒▒▒▒▓▓███▓██▓▓█████▓▒▒▒▒▒▒▒▒▒▒▒▒▒▒▒▒▒▒▒▒▒▒▒▒▒▒▒▒▒▒▒▒▒▒▒▒▒▒▒▒▒▒▒▒▒▒▒▒▒▒▒▒▒▒▒▒▒▒▒▒▒▒▒▒▒▒▒▒▒▒▒▒▒▒▒▒▒
██████████▓▓▓▓▓▓▓▓▓▓▓▓▓▓▓▓▓▓▓▓▓▓▓▓▓▓▓▓▓▓▓▓▓▓▓▓▓▓▓▓▓▓██████████▓▓▓▓▓▓▓▒▓██▓▓█▓▒▒▒▒▒▒▒▒▓▒██████████████████████▓▓▓▒▒▒░▒▒▒▒▒▒▒▒▒▒▒▓▓▓▓▓▓██▓██████▒▒▒▒▒▒▒▒▒▒▒▒▒▒▒▒▒▒▒▒▒▒▒▒▒▒▒▒▒░▒▒▒▒▒▒▒▒▒▒▒▒▒▒▒▒▒▒▒▒▒▒▒▒▒▒▒▒▒▒▒▒▒▒▒▒▒▒▒▒▒▒▒▒▒▒▒▒
▓█▓████▓█▓█▓▓▓▓▓▓▓▓▓▓▓▓▓▓▓▓▓▓▓▓▓▓▓▓▓▓▓▓▓▓▓▓▓▓▓▓▓▓▓▓█████████▓█▓▓▓▓▓▓▒▒▓█▓██▓▒▒▒▒▒▒▒▒▒▓▓███████████████████████▓▓▓▒▒▒▒▒▒▒▒▒▒▒▒▒▒▓▓█▓▓▓▓▓▓▓▓▓███▒▒▒▒▒▒▒▒▒▒▒▒▒▒▒▒▒▒▒▒▒▒▒▒▒▒▒▒▒▒▒▒▒▒▓▒▓▓▓▓▓▓▓▒▓▓▓▓▓▓▓▒▓▒▒▒▒▒▒▒▒▒▒▒▒▒▒▒▒▒▒▒▒▒▒▒▒▒
████████▓▓▓▓▓▓▓▓▓▓▓▓▓▓▓▓▓▓▓▓▓▓▓▓▓▓▓▓▓▓▓▓▓▓▓▓▓▓▓▓▓▓▓████▓▓███▓██▓▓▓▒▒▒▒▓███▓▓▓▒▒▒▒▒▓▒▓▒▓████████████████████████▓▓▒▒▒▒▒▒▒▒▒▒▒▒▒▒▓▓▓▓▓▓▓▓▓▒▒▓▓▓▓▓▓▓▓▓▓▓▓▓▒▒▒▒▒▒▒▒▒▒▒▒▒▒▒▒▒▒▒▒▒▒▒▒▒▒▒▓▓▓▓▓▓▓▒▒▒▓▓▓▓▓▒▓▒▓▓▒▓▒▒▓▒▒▒▒▒▒▒▒▒▒▒▒▒▒▒▒▒
▓█████████▓▓▓▓▓▓▓▓▓▓▓▓▓▓▓▓▓▓▓▓▓▓▓▓▓▓▓▓▓▓▓▓▓▓▓▓▓▓▓▓▓▓▓▓▓▓▓██████▓▓▒▒▒▒▒▓██▓▓▓▒▒▒▒▒▓▒▒▓▓██████████████████████████▓▓▓▒▒▒▒▒▒▒▒▒▒▒▒▓▓▓▓▓▓▓▓▓▒▒▒▒▓▓▓▓▓▓▓▓▓▓▓▓▓▓▓▒▒▒▒▒▒▒▒▒▒▒▒▒▒▒▒▒▒▒▒▒▒▓▓▓▓▓▓▓▒▒▒▒▒▒▓▓▓▒▓▓▓▓▒▓▒▓▓▒▒▒▒▒▒▒▒▒▒▒▒▒▒▒▒▒
▓████▓▓▓▓▓▓▓▓▓▓▓▓▓▓▓▓▓▓▓▓▓▓▓▓▓▓▓▓▓▓▓▓▓▓▓▓▓▓▓▓▓▓▓▓▓▓▓▓▓▓▓▓██████▒▒▒▒▒▒▒▓█▓▓▓▒▒▒▒▒▒▓▒▒▓▓██████████████████████████▓▓▓▓▓▒▒▒▒▒▒▒▒▒▒▒▓▓▓▓▓▓▓▓▒▒▒▒▒▒▒▓▓▓▓▓▓▓▓▓▓▓▓▓▓▓▒▒▒▒▒▒▒▒▒▒▒░░▒▒▒▒▒▒▒▒▓▓▓▓▓▓▓▓▓▓▓▓▓▓▒▓▓▓▓▒▒▒▒▒▒▒▒▒▒▒▒▒▒░▒▒▒▒▒▒▒
█▓█▓▓▓██▓█▓▓▓▓▓▓▓▓▓▓▓▓▓▓▓▓▓▓▓▓▓▓▓▓▓▓▓▓▓▓▓▓▓▓▓▓▓▓▓▓▓▓▓▓▓▓▓▓███▓█▒▒▒▒▒▒██▓▓▓▒▒▒▒▒▒▒▓▒▒▓▓███████████████████████████▓▓▓▓▒▒▒▒▒▒░░░▒▒▒▓▓▒▓▓▓▒▒▒▒▒▒▒▒▒▒▒▓▓▓▓▓▓▓▓▓▓▓▓█▓▓▒▒▒▒▒▒▒▒▒░▒▒░▒▒▒▒▒▓▓▓▓█▓▓▓█▓▓▓█▓▒▓▓▓▒▒▒▒▒▒▒▒▒▒▒▒▒▒▒▒▒▒▒▒▒▒▒
▓█████▓▓▓▓▓▓▓▓▓▓▓▓▓▓▓▓▓▓▓▓▓▓▓▓▓▓▓▓▓▓▓▓▓▓▓▓▓▓▓▓▓▓▓▓▓▓▓▓▓▓▓▓███▓█▓▒▒▒▒██▓▒▓▒▒▒▒▒▒▓▒▓▒▓▓█████████████████████████████▓▓▒▒▒▒▒▒▒▒▒▒▒▒▒▒▒▒▓▓▓▒▒▒▒▒▒▒▒▒▒▒▒▒▓▓▓▓▓▓▓▓▓▓▓▓▓▓▒▒▒▒▒▒▒▒▒▒▒▒▒▒▒▓▒▓█▓▒▓▓▒▓█▓▒▓█▓▒▓▓▓▒▒▒▒▒▒▒▒▒▒▒▒▒▒▒▒▒▒▒▒▒▒▒
▓▓▓▓▓▓▓▓▓▓█▓▓▓▓▓▓▓▓▓▓▓▓▓▓▓▓▓▓▓▓▓▓▓▓▓▓▓▓▓▓▓▓▓▓▓▓▓▓▓▓▓▓▓▓▓▓▓███▓█▓▒▒▓███▒▓▒▒▒▒▒▓▓▓▓▓▓▓▓██████████████████████████████▓▓▒▒▒▒▒▒▒▒▒▒▒▒▒▒▒▒▓▓▒▒▒▒▒▒▒▒▒▒▒▒▒▒▒▓▓▓▓▓▓▓▓▓▓▓▓▒▒▒▒▒▒▒▒▒▒▓▒▒▓▒▓▓▒▓▓▓▓▓▓▓▓▓▓▓█▓▒▓▓▓▒▒▒▒▒▒▒▒▒▒▒▒▒▒▒▒▒▒▒▒▒▒▒
▓▓▓██▓▓▓▓▓▓▓▓▓▓▓▓▓▓▓▓▓▓▓▓▓▓▓▓▓▓▓▓▓▓▓▓▓▓▓▓▓▓▓▓▓▓▓▓▓▓▓▓▓▓▓▓▓▓██▓▓▓▒▓██▓▒▒▓▒▒▒▒▒▒▒▓▓▓▓▓▓███████████████████████████████▓▒▒▒▒▒▒▒▒▒▒▒▒▒▒▒▒▒▒▒▒▒▒▒▒▒▒▒▒▒▒▒▒▒▒▒▒▓▓▓▓▓▓▓▓▓▓▒▒▒▒▒▒▒▒▒▒▒▒▓▓▓▓▓▓▓▓▓▓▓▓▓▓▓▓▓▓▓▓▓▓▓▓▒▒▒▒▒▒▒▒▒▒▒▒▒▒▒▒▒▒▒▒▒
▓▓▓▓▓▓▓█▓▓▓▓▓▓▓▓▓▓▓▓▓▓▓▓▓▓▓▓▓▓▓▓▓▓▓▓▓▓▓▓▓▓▓▓▓▓▓▓▓▓▓▓▓▓▓▓▒▒▓███▓▓▓██▓▒▒▓▒▒▒▒▒▒▒▒▒▒▓▓▓████████████████████████████████▓▓▒▓▒▒▒▒▒▒▒▒▒▒▒▒▒▒▒▒▒▒▒▒▒▒▒▒▒▒▒▒▒▒▒▒▒▒▒▓▓▓▓▓▓▓▓▓▓▓▓▒▒▓▓▒▒▒▒▒▒▒▓▓▓▓▓▓▓▓▓▓▓▓▓▓▓▓▓▓▓▓▓▓▒▒▒▒▒▒▒▒▒▒▒▒▒▒▒▒▒▒▒▒
▓▓▓▓█▓▓▓▓█▓▓▓▓▓▓▓▓▓▓▓▓▓▓▓▓▓▓▓▓▓▓▓▓▓▓▓▓▓▓▓▓▓▓▓▓▓▓▓▓▓▓▓▓▓▒▒▒▒▓██▓███▓▒▒▓▒▒▒▒▒▒▒▒▒▓▓▓▓▓█████████████████████████████████▓▓▒▒▒▒▒▒▒▒▒▒▒▒▒▒▒▒▒▒▒▒▒▒▒▒▒▒▒▒▒▒▒▒▒▒▒▒▒▒▒▓▓▓▓▓▓▓▓▓▓▓▓▒▒▓▓▒▒▒▒▒▒▒▓▓▓▓▓▓▓▓▓▓▓▓▓▓▓▓▓▓▓▓▒▒▒▒▒▒▒▒▒▒▒▓▓▓▒▒▓▒▒
▓██▓▓▓█▓▓▓▓▓▓▓▓▓▓▓▓▓▓▓▓▓▓▓▓▓▓▓▓▓▓▓▓▓▓▓▓▓▓▓▓▓▓▓▓▓▓▓▓▓▓▓▒▒▒▒▒▓██▓██▓▒▒▓▒▒▒▒▒▒▒▒▒▒▒▓▒▓▓██████████████████████████████████▓▓▒▒▒▒▒▒▒▒▒▒▒▒▒▒▒▒▒▒▒▒▒▒▒▒▒▒▒▒▒▒▒▒▒▒▒▒▒▒▒▒▓▓▓▓▓▓▓▓▓▓▓▓▓▓▓▓▓▒▒▒▒▒▒▒▓▓▓▓▓▒▒▒▒▓▓▓▓▓▓▓▓▓▓▓▓▒▒▒▒▒▒▒▒▒▒▒▓▒▒▒
▓▓▓▓█▓▓▓▓▓▓▓▓▓▓▓▓▓▓▓▓▓▓▓▓▓▓▓▓▓▓▓▓▓▓▓▓▓▓▓▓▓▓▓▓▓▓▓▓▓▓▓▓▓▓▒▒▒▒▓██▓▓▓▒▒▓▒▒▒▒▒▒▒▒▒▒▒▓▓▓▓████████████████████████████████████▓▓▒▒▒▒▒▒▒▒▒▒▒▒▒▒▒▒▒▒▒▒▒▒▒▒▒▒▒▒▒▒▒▒▒▒▒▒▒▒▒▒▒▒▓▓▓▓▓▓▓▓▓▓▓▓▓▒▓▓▓▒▒▒▒▒▒▒▒▒▒▒▒▒▒▒▒▓▓▓▓▓▒▓▓▓▒▓▓▓▒▒▒▒▒▒▒▓▒▒▓
▓▓█▓█▓▓█▓▓▓▓▓▓▓▓▓▓▓▓▓▓▓▓▓▓▓▓▓▓▓▓▓▓▓▓▓▓▓▓▓▓▓▓▓▓▓▓▓▓▓▓▓▓▓▒▒▒▒▓███▓▓▓▓▒▒▒▒▒▒▒▒▒▒▒▒▒▒▓▓█████████████████████████████████████▓▒▒▒▒▒▒▒▒▒▒▒▒▒▒▒▒▒▒▒▒▒▒▒▒▒▒▒▒▒▒▒▒▒▒▒▒▒▒▒▒▒▒▒▒▓▓▓▓▓▓▓▓▓▓▓▓▓▓▒▓▓▓▒▒▒▒▒▒▒▓▒▓▓▒▓▓▒▒▒▒▒▓▓▓▒▓█▓▒▓█▓▒▒▓▒▓▓▓
▓█▓▓▓▓▓▓█▓▓▓▓▓▓▓▓▓▓▓▓▓▓▓▓▓▓▓▓▓▓▓▓▓▓▓▓▓▓▓▓▓▓▓▓▓▓▓▓▓▓▓▓▓▓▒▒▒▒▓▓▓█▒▒▓▒▒▒▒▒▒▒▒▒▒▒▒▒▓▓▓▓██████████████████████████████████████▓▓▒▒▒▒▒▒▒▒▒▒▒▒▒▒▒▒▒▒▒▒▒▒▒▒▒▒▒▒▒▒▒▒▒▒▒▒▒▒▒▒▒▒▒▒▓▓▓▓▓▓▒▓▓▓▓▓▒▓▓▒▓█▓░▒▒▒▒▒▒▓▒▒▒▒▒▓▒▒▒▒▒▒▒▒▒▒▓▓▒▒▓▒▓▒▓▓
█▓▓▓▓▓▓▓▓▓▓▓▓▓▓▓▓▓▓▓▓▓▓▓▓▓▓▓▓▓▓▓▓▓▓▓▓▓▓▓▓▓▓▓▓▓▓▓▓▓▓▓▓▓▓▓▒▒▓▓█▓▒▒▓▒▒▒▒▒▒▒▒▒▒▒▒▒▒▒▒▒████████████████████████████████████████▒▒▒▒▒▒▒▒▒▒▒▒▒▒▒▒▒▒▒▒▒▒▒▒▒▒▒▒▒▒▒▒▒▒▒▒▒▒▒▒▒▒▒▒▒▒▒▒▓▓▓▓▓▒▒▓▓▓▓▓▓▓▒▒▓█▓▒▒▒▒▒▒▒▒▒▒▒▒▒▒▒▒▒▒▒▒▓█▓▒▒▓▓▓▓▓▓
████▓▓█▓▓▓▓▓▓▓▓▓▓▓▓▓▓▓▓▓▓▓▓▓▓▓▓▓▓▓▓▓▓▓▓▓▓▓▓▓▓▓▓▓▓▓▓▓▓▓▓▓▒▓██▓▒▒▓▒▒▒▒▒▒▒▒▒▒▒▒▒▓▒▒▓▓████████████████████████████████████████▓▒▒▒▒▒▒▒▒▒▒▒▒▒▒▒▒▒▒▒▒▒▒▒▒▒▒▒▒▒▒▒▒▒▒▒▒▒▒▒▒▒▒▒▒▒▒▒▒▒▓▓▓▓▓▓▒▒▓▓▓▓▒▓▓▒▒▓▓▒▒▒▒▒▒▒▒▒▒▒▒▒▒▒▓▒▒▓▓▒▒▒▓▓▓▓▓▓
▓▓▓▓▓▓▓▓▓▓▓▓▓▓▓▓▓▓▓▓▓▓▓▓▓▓▓▓▓▓▓▓▓▓▓▓▓▓▓▓▓▓▓▓▓▓▓▓▓▓▓▓▓▓▓▓███▓▒▒▓▒▒▒▒▒▒▒▒▒▒▒▒▒▒▒▒▒▒██████████████████████████████████████████▓▒▒▒▒▒▒▒▒▒▒▒▒▒▒▒▒▒▒▒▒▒▒▒▒▒▒▒▒▒▒▒▒▒▒▒▒▒▒▒▒▒▒▒▒▒▒▒▒▒▒▒▒▓▓▓▓▒▒▓▓▓▓▓▒▓▓▒▒▓▓▒▒▒▒▒▒▒░▒▒▒▓▒▒▒▓▒▒▒▒▓▒▓▓██
▓▓▓▓▓▓▓▓▓▓▓▓▓▓▓▓▓▓▓▓▓▓▓▓▓▓▓▓▓▓▓▓▓▓▓▓▓▓▓▓▓▓▓▓▓▓▓▓▓▓▓▓▓▓▓▓██▓▒▒▒▒▒▒▒▒▒▒▒▒▒▒▒▒▒▒▒▒▓▓███████████████████████████████████████████▓▒▒▒▒▒▒▒▒▒▒▒▒▒▒▒▒▒▒▒▒▒▒▒▒▒▒▒▒▒▒▒▒▒▒▒▒▒▒▒▒▒▒▒▒▒▒▒▒▒▒▒▒▒▓▓▓▓▒▒▒▓▓▓▓▓▓▓▓▒▒▓▓▒▒▒▒▒▒▒▒▒▒▒▒▓▒▒▒▒▓▓▓▓██
▓▓▓▓▓▓▓▓▓▓▓▓▓▓▓▓▓▓▓▓▓▓▓▓▓▓▓▓▓▓▓▓▓▓▓▓▓▓▓▓▓▓▓▓▓▓▓▓▓▓▓▓▓▓▓▓▓▓▒▒▒▒▒▒▒▒▒▒▒▒▒▒▒▒▒▒▒▒▒▒▓████████████████████████████████████████████▒▒▒▒▒▒▒▒▒▒▒▒▒▒▒▒▒▒▒▒▒▒▒▒▒▒▒▒▒▒▒▒▒▒▒▒▒▒▒▒▒▒▒▒▒▒▒▒▒▒▒▒▒▒▓▓▓▓▓▒▒▒▒▓▓▓▓▓▓▓▓▒▒▓▓▒░▒▒▒▒▒▒▒▒▒▒▒▒▒▓▓███
▓▓▓▓▓▓▓▓▓▓▓▓▓▓▓▓▓▓▓▓▓▓▒▓▓▓▓▓▓▓▓▓▓▓▓▓▓▓▓▓▓▓▓▓▓▓▓▓▓▓▓▓▓▓▓▓▓▒▒▓▓▒▒▒▒▒▒▒▒▒▒▒▒▒▒▒▒▒▒▒██████████████████████████████████████████████▒▒▒▒▒▒▒▒▒▒▒▒▒▒▒▒▒▒▒▒▒▒▒▒▒▒▒▒▒▒▒▒▒▒▒▒▒▒▒▒▒▒▒▒▒▒▒▒▒▒▒▒▒▒▒▒▒▒▓▓▒▒▒▒▒▓▓▓▓▓▓▓▒▒▒▓▓▒▒▒▓▒▒▒▒▒▒▒▒▓████
▓▓▓▓▓▓▓▓▓▓▓▓▓▓▓▓▓▓▓▓▓▓▓▓▓▓▓▓▓▓▓▓▓▓▓▓▓▓▓▓▓▓▓▓▓▓▓▓▓▓▓▓▓▓▓▓▓▓▓▓▒▒▒░▒▒▒▒▒▒▒▒▒▒▒▒▒▒▒▓███████████████████████████████████████████████▒▒▒▒▒▒▒▒▒▒▒▒▒▒▒▒▒▒▒▒▒▒▒▒▒▒▒▒▒▒▒▒▒▒▒▒▒▒▒▒▒▒▒▒▒▒▒▒▒▒▒▒▒▒▒▒▒▒▒▒▓▒▒▒▒▒▓▓▓▓▓▒▓▓▒▒▒▓▓▒▒▒▒▒▒▒▒▓▓▓███
▓▓▓▓▓▓▓▓▓▓▓▓▓▓▓▓▓▓▓▓▓▓▓▒▓▓▓▓▓▓▓▓▓▓▓▓▓▓▓▓▓▓▓▓▓▓▓▓▓▓▓▓▓▓▓▓▓▓▓▒▒▒░▒▒▒▒▒▒▒▒▒▒▒▒▒▒▒▒▓███████████████████████████████████████████████▓▒▒▒▒▒▒▒▒▒▒▒▒▒▒▒▒▒▒▒▒▒▒▒▒▒▒▒▒▒▒▒▒▒▒▒▒▒▒▒▒▒▒▒▒▒▒▒▒▒▒▒▒▒▒▒▒▒▒▒▒▒▒▓▓▒▒▒▒▓▓▓▓▒▒▓▒▒▒▒▓▒▒▒▒▒▒▓▓█▓██
▓▓▓▓▓▓▓▓▓▓▓▓▓▓▓▓▓▓▓▓▓▓▓▓▓▓▓▓▓▓▓▓▓▓▓▓▓▓▓▓▓▓▓▓▓▓▓▓▓▓▓▓▓▓▓▓▓▓▒▒▒░▒▒▒▒▒▒▒▒▒▒▒▒▒▒▒▒▒█████████████████████████████████████████████████▓▒▒▒▒▒▒▒▒▒▒▒▒▒▒▒▒▒▒▒▒▒▒▒▒▒▒▒▒▒▒▒▒▒▒▒▒▒▒▒▒▒▒▒▒▒▒▒▒▒▒▒▒▒▒▒▒░░▒▒▒▒▒▒▒▒▒▒▒▒▓▓▓▒▒▒▒▒▒▒▒▒▒▒▓▓▓▓▓▓█