░░░░░░░░▒░▒░▒▒▒▒▒▒▒▒▒▒▒▒▒▒▒▒▒▒▒▒▒▒▒▒▒▒▒▒▒▒▒▒▒▒▒▒▒▒▒▒▒▒▒▒▒▒▒▒▒▒▒▒▒▒▒▒▒▒▒▒▒▒▒▓▓▓▓▓▓▓▓▓▓▓▓▓▓▓▓▓▓▓▓▓▓▓▓▓▓▓█████████████████████████████████████████████████████████████████████████████████████████████████▓▓▓▓▓▓▓▓▓▓▓▓▓▓▓▓▓▓▓▓▓
░░░░░▒▒▒░▒▒▒░▒▒▒▒▒▒▒▒▒▒▒▒▒▒▒▒▒▒▒▒▒▒▒▒▒▒▒▒▒▒▒▒▒▒▒▒▒▒▒▒▒▒▒▒▒▒▒▒▒▒▒▒▒▒▒▒▒▒▒▒▓▓▓▓▓▓▓▓▓▓▓▓▓▓▓▓▓▓▓▓▓▓▓▓▓▓▓█████████████████████████████████████████████████████████████████████████████████████████████████████▓▓▓▓▓▓▓▓▓▓▓▓▓▓▓▓▓▓▓
░░░░░░▒▒▒▒▒▒▒▒▒▒▒▒▒▒▒▒▒▒▒▒▒▒▒▒▒▒▒▒▒▒▒▒▒▒▒▒▒▒▒▒▒▒▒▒▒▒▒▒▒▒▒▒▒▒▒▒▒▒▒▒▒▒▒▒▒▓▓▓▓▓▓▓▓▓▓▓▓▓▓▓▓▓▓▓▓▓▓▓▓▓▓█████████████████████████████████████████████████████████████████████████████████████████████████████████▓▓▓▓▓▓▓▓▓▓▓▓▓▓▓▓▓▓
░░░░░▒▒▒▒▒▒▒▒▒▒▒▒▒▒▒▒▒▒▒▒▒▒▒▒▒▒▒▒▒▒▒▒▒▒▒▒▒▒▒▒▒▒▒▒▒▒▒▒▒▒▒▒▒▒▒▒▒▒▒▒▒▒▒▒▓▒▓▓▓▓▓▓▓▓▓▓▓▓▓▓▓▓▓▓▓▓▓▓▓▓█▓███████████████████████████████████████████████████████████████████████████████████████████████████████████▓▓▓▓▓▓▓▓▓▓▓▓▓▓▓▓
░░░░░▒▒▒▒▒▒▒▒▒▒▒▒▒▒▒▒▒▒▒▒▒▒▒▒▒▒▒▒▒▒▒▒▒▒▒▒▒▒▒▒▒▒▒▒▒▒▒▒▒▒▒▒▒▒▒▒▒▒▒▒▒▒▒▓▓▓▓▓▓▓▓▓▓▓▓▓▓▓▓▓▓▓▓▓▓▓▓▓▓█▓█████████████████████████████████████████████████████████████████████████████████████████████████████████████▓▓▓▓▓▓▓▓▓▓▓▓▓▓▓
░░░░░▒▒▒▒▒▒▒▒▒▒▒▒▒▒▒▒▒▒▒▒▒▒▒▒▒▒▒▒▒▒▒▒▒▒▒▒▒▒▒▒▒▒▒▒▒▒▒▒▒▒▒▒▒▒▒▒▒▒▒▒▒▓▒▓▓▓▓▓▓▓▓▓▓▓▓▓▓▓▓▓▓▓▓▓▓▓▓█▓████████████████████████████████████████████████████████████████████████████████████████████████████████████████▓▓▓▓▓▓▓▓▓▓▓▓▓▓
░░░░░▒▒▒▒▒▒▒▒▒▒▒▒▒▒▒▒▒▒▒▒▒▒▒▒▒▒▒▒▒▒▒▒▒▒▒▒▒▒▒▒▒▒▒▒▒▒▒▒▒▒▒▒▒▒▒▒▒▒▓▓▓▓▓▓▓▓▓▓▓▓▓▓▓▓▓▓▓▓▓▓▓▓▓▓▓▓████████████████████████████████████████████████████████████████████████████████████████████████████████████████████▓▓▓▓▓▓▓▓▓▓▓▓▓
░░░░░▒▒▒▒▒▒▒▒▒▒▒▒▒▒▒▒▒▒▒▒▒▒▒▒▒▒▒▒▒▒▒▒▒▒▒▒▒▒▒▒▒▒▒▒▒▒▒▒▒▒▒▒▒▓▓▓▓▓▓▓▓▓▓▓▓▓▓▓▓▓▓▓▓▓▓▓▓▓▓▓▓▓█████████████████████████████████████████████████████████████████████████████████████████████████████████████████████████▓▓▓▓▓▓▓▓▓▓▓▓
░░░░░▒▒▒▒▒▒▒▒▒▒▒▒▒▒▒▒▒▒▒▒▒▒▒▒▒▒▒▒▒▒▒▒▒▒▒▒▒▒▒▒▒▒▒▒▒▒▓▒▓▒▓▓▓▓▓▓▓▓▓▓▓▓▓▓▓▓▓▓▓▓▓▓▓▓▓▓▓▓▓█████████████████████████████████████████████████████████████████████████████████████████████████████████████████████████████▓▓▓▓▓▓▓▓▓▓▓
░░░░░▒▒▒▒▒▒▒▒▒▒▒▒▒▒▒▒▒▒▒▒▒▒▒▒▒▒▒▒▒▒▒▒▒▒▒▒▒▒▒▓▓▓▓▓▓▓▓▓▓▓▓▓▓▓▓▓▓▓▓▓▓▓▓▓▓▓▓▓▓▓▓▓▓▓███████████████████████████████████████████████████████████████████████████████████████████████████████████████████████████████████▓▓▓▓▓▓▓▓▓▓
░░░░░░▒▒▒▒▒▒▒▒▒▒▒▒▒▒▒▒▒▒▒▒▒▒▒▒▒▒▒▒▒▒▒▒▒▒▓▓▓▓▓▓▓▓▓▓▓▓▓▓▓▓▓▓▓▓▓▓▓▓▓▓▓▓▓▓▓▓▓▓▓████████████████████████████████████████████████████████████████████████████████████████████████████████████████████████████████████████▓▓▓▓▓▓▓▓▓
░░░░░░░▒░▒▒▒▒▒▒▒▒▒▒▒▒▒▒▒▒▒▒▒▒▒▒▒▒▒▒▒░░░░░▒▒▒▒▒▒▒▒▒▒▒▒▒▒▒▒▒▒▒▓▓▓▓▓▓▓▓▓▓▓▓▓████████████████████████████████████████████████████████████████████████████████████████████████████████████████████████████████████████████▓▓▓▓▓▓▓
░░░░░░▒░▒▒▒▒▒▒▒▒▒▒▒▒▒▒▒▒▒▒▒▒▒▒▒▒▒▒▒░░░░░░      ░░░░▒░░░▒▒▒▒▒▒▒▒▒▒▒░░░▒▒▒▒▒▒▒▒▒▒▒▒▒▒▒▒▒▒▒▒▒▒▒░▒▒▒▒▒▒▒▒▒▓▓▓▓▓███████████████████████████████████████████████████████████████████████████████████████████████████████████▓▓▓▓▓▓
░░░░░░▒▒░▒▒▒▒▒▒▒▒▒▒▒▒▒▒▒▒▒▒▒▒▒▒▒▒▒▒░░░░░░░░░░░░  ░░▒▓▓▓▓▒▒▒▒▒▒▒▒▒▒▒▓▓▓▓▓▓▓▒░░░▒▒▒▒▒▒▒▒▒▒▒▒▒▒▒▒▒▒▒▒▒▒▒▒▒▒▒▓▒▒▓▓███▓▓▓▓▓▓▓▓▓▓▓▓▓▓▓▓▓▓▓▓▓▓▓▓▒▓▒▒▒▒▒▒▒▒▒▒▓███████████████████████████████████████████████████████████████████▓▓▓
░░░░░░░▒▒▒▒▒▒▒▒▒▒▒▒▒▒▒▒▒▒▒▒▒▒▒▒▒▒▒▒░░░ ░░░░░░░░░  ░▒▒▒▓▓▓▓▒▒▒▒▒▒▒▒▒▒▒▒▒▒▒▒▒░▒░▒▒▒▒▒▒▒▒▒▒▒▒▒▒▒▒▒▒▒▒▒▒▒▒▓▒▒▓▒▒▒▓▓▓▓▓▓▓▓█▓▓▓▓▓▓▓▓▓▓▓▓▓▓▓▓▓▓▓▓▓██████████████████████████████████▓▓▓▓▓▓▓▓█████████████████████████████████▓▓▓▓▓▓
░░░░░░░▒▒▒▒▒▒▒▒▒▒▒▒▒▒▒▒▒▒▒▒▒▒▒▒▒▒▒▒░░░ ░░░▒░░░    ░▒▒▒▒▒▒▒▒▒▒▒▒▒▒░▒▒▒▒▒▒▒▒▒▒░░▒▒▒▒▒▒▒▒▒▒▒▒▒▒▒▒▒▒▒▒▒▒▒▒▒▒▒▓▒▒▒▓▓▓▓▓▒▒▓▓▓▓▓▓▓▓▓▓▓▓▓▓▓▓▓▓▓▓▓▓▓███████████████████████████████████▓▒▒▒▒▒▒▒▒▒▒▒▒▒▒▒▒▒▒▒▒▒▒▒▒▒▒▒▒▒▒▒▒▒▒▒▒▒▒▒▒▒▒▒▒▒
░░░░░░░▒▒▒▒▒▒▒▒▒▒▒▒▒▒▒▒▒▒▒▒▒▒▒▒▒▒▒▒▒░░ ░▒▒▒░▒▒░░  ░▒▒▒▒▒▒▒▒▒▒▒▒▒▒▒░░▒▒▒▒▒▒▒▒▒▒▒▒▒▒▒▒▒▒▒▒▒▒▒▒▒▒▒▒▒▒▒▒▒▒▒▒▒▒▒▒▒▒▒▓▓▓▒▒▒▓▓▓▓▓▓▓▓▓▓▓▓▓▓▓▓▓███████████████████████████████████████▓▓▒▒▒▒▒▒▒▒▒▒▒▒▒▒▒▒▒▒▒▒▒▒▒▒▒▒░▒░▒░░░░░░░░░░░░░▒▒
░░░░░░░▒▒▒▒▒▒▒▒▒▒▒▒▒▒▒▒▒▒▒▒▒▒▒▒▒▒▒▒░░░ ░▒▒░▒▒▒▒░  ░▒▒▒▒▒▒▒▒▒▒▒▒▒▒▒▒▓▓▓▓▓▓▓▓░░░▒▒▒▒▒▒▒▒▒▒▒▒▒▒▒▒▒▒▒▒▒▒▒▒▒▒▓████▓█▓▓▓▓▓▓▓▓▓▓▓▓▓▓▓▓▓▓▓▓▓▓▓▓█▓▓███████████████████████████████████▓▒▒▒▒▒▒▒▒▒▒▒▒▒▒▒▒▒▒▒▒▒▒▒▒▒░▒░▒░░░░░░░░░░░░░░▒▒▒
░░░░░░░▒▒▒▒▒▒▒▒▒▒▒▒▒▒▒▒▒▒▒▒▒▒▒▒▒▒▒▒▒░░      ░░░░  ░▒▒▒▒▒▒▒▒▒▒▒▒▒▒▒▒▒▓▒▓▓▒▒▒▒▒░▓███████████████████████████████████████▓████████████▓▓▓██████████████████████████████████████▓▓▓▒▒▒▒▒▒▒▒▒▒▒▒▒▒▒▒▒▒▒▒▒▒▒▒▒▒▒▒▒▒▒▒▒░░░░░░▒▒▒▒▒▒
░░░░░░░▒▒▒▒▒▒▒▒▒▒▒▒▒▒▒▒▒▒▒▒▒▒▒▒▒▒▒▒▒░░░░░░░░░░░░░ ░▒▒▓▓▓▓▓▒░░░░▒▒▒░░░░░░░▒▒░░░▓█▓▓▓▓▓▓▓█▓█▓▓▓▓▓▓▓█████████████████████▓████████████▓▓▓▓█████████████████████████████████████▓▓▓▒▒▒▒▒▒▒▒▒▒▒▒▒▒▒▒▒▒▒▒▒▒▒▒▒▒▒▒▒▒▒▒▒▒▒▒░▒▒▒▒▒▒▒▒
░░░░░░░▒▒▒▒▒▒▒▒▒▒▒▒▒▒▒▒▒▒▒▒▒▒▒▒▒▒▒▒▒░░          ░░░▒░▓▓▒▒▒░░░░░▒▒▒░░░▒▒░░▒▒▒▒░▓███████████████████████████████████████▓█▒▒▒▓▓██▓▓▓█▓▓▓▓▓████████████████████████████████████▓▓▓▓▓▓▓▓▓▓▓▓▓▓▓▒▒▒▒▒▒▒▒▒▒▒▒▒▒▒▒▒▒▒▒▒▒▒▒▒▒▒▒▒▒▒▒▒
░░░░░░░▒▒▒▒▒▒▒▒▒▒▒▒▒▒▒▒▒▒▒▒▒▒▒▒▒▒▒▒▒░░░▒▒▓▒▓▓▒▒▓░ ░▒▒▒░░▒░░▒░▒▒▒▒▒░░░░░░░▒▒▒▒▒▒▒▓▓█▓▓█▓▓▓█▓█▓▓▓▓▓█▓▓▓▓▓███████████████▓█▓▓▓▓██▓▒▓▒█▓▓▓██████████████████████████████████████▓▓▓▓▓▓▓▓▓▓▓▓▓▓▓▒▒▒▒▒▒▒▒▒▒░░▒▒▒▒▒▒▒▒▒▒▒▒▒▒▒▒▒▒▒▒▒
░░░░░░░▒▒▒▒▒▒▒▒▒▒▒▒▒▒▒▒▒▒▒▒▒▒▒▒▒▒▒▒▒░░░░░▒░▒▒▒░░░ ░▒▒▓█▓██▓▓▓▓▓▒▒▒░░░░░░░░▒▒░░▓███████████████████████████████████████▓█▓▓▒▓▓▓▒▓▓▒█▓▓▓▓█████████████████████████████████████▓▓▓▓▓▓▓▓▓▓▓▓▓▓▓▒▒▒▒▒▒▒▒▒▒▒▒░▒▒▒▒▒▒▒▒▒▒▒▒▒▒▒▒▒▒▒▒
░░░░░░░░▒▒▒▒▒▒▒▒▒▒▒▒▒▒▒▒▒▒▒▒▒▒▒▒▒▒▒▒░░░░▒▒▒▒▒▒░░░ ░▒░░▓▓▓▓▓▓▓▓▓▒▒▒░░░░░░░░░░░░▓███▓▓▓██▓▓█▓▓█▓█▓█▓▓█████▓▓▓▓▓▓▓██▓▓██▓▓█▓▒▓▓▓▓▒▒▒▒█▓▓▓██████████████████████████████████████▓▓▓▓▓▓▓▓▓▓▓▓▓▓▓▒▒▒▒▒▒▒▓▓▓▓▒▒▒▒▒▒▒▒▒▒▒▒▒▒▒▒▒▒▒▒▒▒
░░░░░░░░▒▒▒▒▒▒▒▒▒▒▒▒▒▒▒▒▒▒▒▒▒▒▒▒▒▒▒▒▒░░▒▒▒▒▒▒▒▒▒▒░░▒░░░░░▒▓▓▓▓▓▒▒▒▒▓▓▒░░░░░░░░▓▓▓██▓█▓██▓███▓███████████▓▒░░░▒▒▒▒▒▒░▒▒▓████████████▓████████████▓▓▓▓▓▓██████████████████████▓▓▓▓▓▓▓▓▓▓▓▓▓▓▓▒▓▓▒▒▒▓▓▓▓▓▒▒▒▒▒▒▒▒▒▒▒▒▒▒▒▒▒▒▒▒▒▒
░░░░░░░░▒▒▒▒▒▒▒▒▒▒▒▒▒▒▒▒▒▒▒▒▒▒▒▒▒▒▒▒▒░░░░░░░░▒▒▒▒▒░░▒▒▒▒▒▒▓▓▓▓▓▒▒▒░▒▒░░░░░▒▒▒▒▓▓▓▓▓▓▓██▓▓█▓▓▓▓▓▓▓█▓▓▓▓▓▓▓▒░▒▓▓▒▓▓▒▒▒░▒▓██▓█████████▓█████████████████▓█████████████████████▓▓▓▓▓▓▓▓▓▓▓▓▓▓▓▓▓▓▓▓▓▓▓▓▒▒▒▒▒▒▒▒▒▒▒▒▒▒▒▒▒▒▒▒▒▒▒▒▓
░░░░░░░░▒▒▒▒▒▒▒▒▒▒▒▒▒▒▒▒▒▒▒▒▒▒▒▒▒▒▒▒▒░░░░░░░░░░░░░░░░░░░░░░░░░░░▒▒▓▓▓▓▓▓▓▓▓▓▒▒▓████████████████████████▓▓▒░▒▒▒▒▒▓▓▒▒▒▒▓██▓▓████████▓█████████████████▓█████████████████████▓▓▓▓▓▓▓▓▓▓▓▓▓▓▓▓▓▓▓▓▓▓▓▓▓▒▒▒▒▒▒▒▒▒▒▒▒▒▒▒▒▒▒▒▒▒▒▒▓
░░░░░░░░▒▒▒▒▒▒▒▒▒▒▒▒▒▒▒▒▒▒▒▒▒▒▒▒▒▒▒▒▒░▒▒▒▓▒▒▓▓▓▓▓▒▒░▒▓▓▓▓▓▓▓███▓▓▓█████████▓▓▓▓▓▓▓▓▓▒▓██████████████████▓▒░▒▒▒▒▒▒▒▓▓▓▓▓█▓▓▓▓██▓████▓█████████████████▓█████████████████████▓▓▓▓▓▓▓▓▓▓▓▓▓▓▓▓▓▓▓▓▓▓▓▒▒▒▒▒▒▒▒▒▒▒▒▒▒▒▒▒▒▒▒▒▒▒▒▒▓
░░░░░░░░▒▒▒▒▒▒▒▒▒▒▒▒▒▒▒▒▒▒▒▒▒▒▒▒▒▒▒▒▒░▒▓▓▓▓▓▓▓▓▓▓▒▒▒▒▓██▓███████▓▓▓▓▓▓▓███▓▓▒▓▓█████████████████████████▓▒▒▒▒▒▒▒▒▒▓▓▓▓▓▓▓▓▓▓▒▓▓▓▓▓▓▓████████████████▓██████████████████████▓▓▓▓▓▓▓▓▓▓▓▓▓▓▓▓▓▓▓▓▓▓▓▒▒▒▒▒▒▒▒▒▒▒▒▒▒▒▒▒▒▒▒▒▒▒▒▒▓
░░░░░░░░▒▒▒▒▒▒▒▒▒▒▒▒▒▒▒▒▒▒▒▒▒▒▒▒▒▒▒▒▒░▒▓▒▓▒▓▓▓▓▓▒▓▒░▒▓▒▓▓▓▓▓▓▓▓▓▒▒▓▓██████▓▓▒▒▒░░░░░░░░░░░░░░░░░░░▒░░░░░▒▓▒▒▓▒▒▒▓▒▒▒▒▓▓▒▒▒▒▒▒▒▒▒▓▓▓▓████████████████▓▓█████████████████████▓▓▓▓▓▓▓▓▓▓▓▓▓▓▓▓▓▓▒▒▒▒▒▒▒▒▒▒▒▒▒▒▒▒▒▒▒▒▒▒▒▒▒▒▒▒▒▒▓
░░░░░░░░▒▒▒▒▒▒▒░░▒▒▒▒        ░▒▒▒▒▒▒▒░▒▓▒▒▒▒▒▒▒▒▒▒▒░▒▓▓▓▓▓▓▓█▓▒▒▒▒▓▓▓▓▓▓▓▓▓▓▓▒▒▒▒▒▒▒▒▒▒▒▒▒▒▒▒░░░▒▓▒▒▓▒░░▒▓▒▒▓▓▒▒▒▒▒▒░▓▒▒▒▓█▒▓▓▒▓▓▓▓▓████████████████▓▓█████████████████████▓▓▓▓███████████▓▓▓▓▓▓▓▓████▓▒▒▒▒▒▒▒▒▒▒▒▒▒▒▒▒▒▒▒▓▓
░░░░░░░░░▒▒▒▒▒▒░░░▒░ ░░░     ░▒▒▒▒▒▒▒░▒▒▒▓▒▒▓▓▒▒▒▒▒▒░▓█▓████▓▓▒▒▒▓▓▓▓▓▓▒▒▓▓▒▓▓▓▒▒▒▒▒▒▒▒▒▒▒▒▒▒░▒▓▒░▒▒▒▓▓░▒▓▒▒▒▒▒▒▒▒▒▒░▒▒▓████████▓▓▓▓████████████████▓▓█████████████████████▓▓▓▓███████████▓▓▓▓▓▓▒██▒▒▒▒██▒▒▒▒▒▒▒▒▒▒▒▒▒▒▒▒▒▓▓
░░░░░░░░░▒▒▒▒▒▒░         ░░  ░▒▒▒▒▒▒▒░▒▒▓▒▓▒▓▒▒▒▒▒▒▒░▒▒▒▓▒▒▓▓▒▒▒▒▓████████████▓▒▒▒░░░░░░░░░▒▒▒▒░▒▓▓▓▒░▒▓▒▓▒▒▒▒▒▒▒▒▒▒░▒▒▒▓▓▓▓█▓▓▓▓▓▓▓████████████████▓▓█████████████████████▓▓▓▓███████████▒▓▓▓▓▓▒█▓▒▒▒▒▒█▓▒▒▒▒▒▒▒▒▒▒▒▒▒▒▒▒▓▓
░░░░░░░░░▒▒▒▒▒▒░░░░░░░░░▒▒░░ ░▒▒▒▒▒▒▒▒▒▒▒▒▒▒▒▒▒▒▒▒▒▒░▒▒▒▒▒▒▒▒▒▒▒▒▓█▓▓█▓▓▓█████▓▒▒▒▒▓▒▒▒▒▒░░▒▒░▒▒░▒▒▒▒▒░░░▓▓▓▓▓▓▓▓▓▓▓▓▓▒▓████▓███▓▓▓▓████████████████▓▓█████████████████████▓▓▓▓██████████▓▒▓▓▓▓▓▒█▓▒▒▒▒▓█▒▒▒▒▒▒▒▒▒▒▒▒▒▒▒▒▒▓▓
░░░░░░░░░▒▒▒▒▒▒░        ░░   ░▒▒▒▒▒▒▒▒░░▒▒▒▒▒▒▒▒░░ ░▒░░░░░░░░░░░░▒█▓▓▓▓▓▓█████▓▒▒▒▒░░▒▒░░░░▒▒░░░▒░░░▒░░░▒▒▒▒▒▒▒▓▓▓▒▒▒▒▒▒▓▓██████▓▓▓▓████████████████▓▓████████████████████▓▓▓▓▓██████████▓▒▓▓▓▓▓▒█▓▓▓▓█▓▒▒▒▒▒▒▒▒▒▒▒▒▒▒▒▒▒▒▓▓
░░░░░░░░░▒▒▒▒▒▒░             ░▒▒▒▒▒▒▒▒░░▒▒▒▒▒▒▒░░░ ░▒░▒▒▒▒▒▒▒▒▒░░▒▓▓▓▓▓█████▓▓▒░░░▒▒▒▒▒▒░░ ░▒▒▒▒▒▒▒▒▒░░░▒▒░░░░░▒▓▓▓▓▒▒▒▓████████▓▓▓▓████████████████▓▓████████████████████▓▓▓▓▓██████████▓▒▓▓▓▓▓▓█▓▓▓▓▓▓█▓▒▒▒▒▒▒▒▒▒▒▒▒▒▒▒▒▓▓
░░░░░░░░░▒▒▒▒▒▒▓▓▒▒▒▒▒▒▒▒▒▓▓▓▓▒▒▒▒▒▒▒▒░▒▒▒▓▓▓▓▓▓▒ ░░▒░░░░░░░░▒░░░▒▓▓▓▓▓▓▓▓▓▒▓▓▒░▒▒▒▒▒░▒▒▒ ░░▒░░░▒▒▒▒░░░░░░░░░░░▒███▓▒▒▒▒▒▒▒▒▒▒▒▓▓▓▓▓████████████████▓█████████████████████▓▓▓▓▓█████████▓▒▒▒▓▒▒▒▓█▒▒▒▒▒▒▒█▒▒▒▒▒▒▒▒▒▒▒▒▒▒▒▓▓▓
░░░░░░░░░▒▒▒▒▒▒▓▓▓▓▓▓▓▓▓▓▓▓▓▓▓▒▒▒▒▒▒▒▒▒▒▓▓▓▓▓▒▒▒▒▒░░▒░░░░░░░░░░░░▒▓▓▓▓▓▒░░░░░░░░░▒▒▒▒░░░░ ░░▒▒▒▒▒░░░░▒░░░▒▒▒░░░▒███▓▒▒▒▒▓▒▓▒▓▓▓▓▓▓▓▓█▓▓▓█▓▓▓▓▓▓▓▓▓▓▓▓█████████████████████▓▓▓▓▓▓▓▓▓▓▓▓▓▓▓▒▒▒▒▒▒▒▓█▒▒▒▒▒▒▒█▒▒▒▒▒▒▒▒▒▒▒▒▒▒▒▓▓▓
░░░░░░░░░░▒▒▒▒▒▓▓▓▓▓▓▓▓▓▓▓▓▒▓▓▒▒▒▒▒▒▒▒░░░░▒▒▒▒▒▒░  ░▒░ ░░░░░░░░░░▒▓▓▓▓▓▒▒▒▒ ▒▒▒▒░░░░░▒▒▒▒░░░▒░▒▒▒▒▒▒░░░░░░░░░░░░▓██▓▓▒▒▒▒▒▒▒▒▒▒▒▒▒▒▒▒▒▒▒▓▓▓▓▓▓▓▓▓▓▓▒▓█████████████████████▓▓▓▓▓▓▓▓▓▓▓▓▓▓▓▒▒▒▒▒▒▒▓█▒▒▒▒▒▓█▒▒▒▒▒▒▒▒▒▒▒▒▒▒▒▒▓▓▓
░░░░░░░░░░▒▒▒▒▒▓▒▒▒▒▒▒▒▓▒▓▓▓▓▓▒▒▒▒▒▒▒▒▒░▒▒▒▒▒▒▒▒▒  ░▒░ ░░░░░░░░ ░▒▓▒▒▒▒▒▒▒▒▒▒▒▒▓▒░░░░░░░░░ ░▓▓▓▓▓▒▒▒▒▒▒▒░▒▓▓▒▒▒░▒▓█▓▒▓▒▒▒▓▓▓▓▓▓▓▓▓▓▓▓▒▒▒▓░░░░░░░▒▒▒▓▓█████████████████████▓▓▓▓▓▓▓▓▓▓▓▓▓▓▓▒▒▒▒▒▒▒▓████▓▓▒▒▒▒▒▒▒▒▒▒▒▒▒▒▒▒▒▒▓▓▓
░░░░░░░░░░▒▒▒▒▒▒▒▒▒▒▒▒▒▒▒▒▒▒▒▒▒▒▒▒▒▒▒▒▒░░░░░░░░░   ░▒░ ░░░░░░░░░░▒▓███▒▒▒▒▓▓▓▒▒▓▒░▒▒░░░░░░░░▒▒▒▓▒▒▒▒▒▒▒░░░▒▒▒▒▒░▒██▓▓▒▒▒▓▓▓▓▓▒▒▒▒▒▒▓███▒▓░░░░░░░▒░▒▓▓█████████████████████▓▓▓▓▓▓▓▓▓▓▓▓▓▓▓▒▒▒▒▒▒▒▒▒▒▒▒▒▒▒▒▒▒▒▒▒▒▒▒▒▒▒▒▒▒▒▒▓▓▓
░░░░░░░░░░▒▒▒▒▒▒▒▒▒▒▒▒▒▒▒▒▒▒▒▒▒▒▒▒▒▒▒▒▒░░░░░░░░░░░░░▒░░▒▒▒░░░░░░░▒▒▒▒▒▒▒▒▒▒▒▒▒▒▓▒▒▒▒▒▒▒▒▒▒▒▒▓▓▓▓▓▓▒▒▒▒░░░░░░░░░░▒██▓▒▒▒▒▒▒▒▒▒▒▒▒░▒▒████▓▒▒▒▒▒▒▒░░░▒▓▓█████████████████████▓▓▓▓▓▓▓▓▓▓▓▓▓▓▒▒▒▒▒▒▒▒▒▒▒▒▒▒▓▓▒▒▒▒▒▒▒▒▒▒▒▒▒▒▒▒▒▓▓▓
░░░░░░░░░░▒▒▒▒▒▒▒▒▒▒▒▒▒▒▒▒▒▒▒▒▒▒▒▒▒▒▒▒▒░ ░░        ░▒▒▒▒▒▒▒▒▒▒▒▒▒▒▒░▒▒▒▒▒▒▒▒▒▒▒▓▓▓▓▓▓███████████▓▓▓▒▒░░░░░░░░░░░▒██▓▒▒▒▒▒▒▒▓▓▓▒▒░░░████▓▒░░░░░░░░░▒▓▓████████████████████▓▓▓▓▓▓▓▓▓▓▓▓▓▓▒▒▒▒▒▒▒▒▒▒▒▒▒▒▒▓▓▓▓▒▒▒▒▒▒▒▒▒▒▒▒▒▒▒▓▓▓
░░░░░░░░░░▒▒▒▒▒▒▒▒▒▒▒▒▒▒▒▒▒▒▒▒▒▒▒▒▒▒▒▒▒░░▒▒▒▒▒░▒    ▒▒▒▓▓▒▒▓▒▒░░▒▒▒▒▒▒▒▒▒▒▒▒▒░▒▓█████████████▓▓▒▒▒▒▒▒░░▒▒▒▓▓▓▒▒▒▓▓▓▓▓█▒▒▒▒█████░░░░▓████▒░░░░░░░░░▒▓▓████████████████████▓▓▓▓▓▓▓▓▓▓▓▓▓▓▓▒▒▒▒▒▒▒▒▒▒▒▒▒▒▓▓▒▒▒▒▒▒▒▒▒▒▒▒▒▒▒▒▓▓▓▓
░░░░░░░░░░▒▒▒▒▒▒▒▒▒▒▒▒▓▓▓▓▓▒▒▒▒▒▒▒▒▒▒▒▒░ ░▒▒▒▒▒▒▒▒▒░▒▒▒▒▓▒▓▒▓░░▒▓▓▒▒▒▒▒░▒▓▓▒▒░▒▓█████████████▒▒▒▒▒▒▒▒▒▒░▒▓██████▓▓▓▓▓█▒▒▒▒▓████▒░░░█▓▒▒▓▒░░░░▒▒▒▒░▒▓▓████████████████████▓▓▓▓▓▓▓▓▓▓▓▓▓▓▓▒▒▒▒▒▒▒▒▒▒▒▒▒▒▒▒▓▓▓▒▒▒▒▒▒▒▒▒▒▒▒▒▓▓▓▓
░░░░░░░░░░▒▒▒▒▒▒▒▒▒▒▒▒▓▓▓▓█▓▒▒▒▒▒▒▒▒▒▒▒░ ░▒▒▒▒▒▒▒▒  ▒░░▒▒▓▓▓▒░▒▒░░▒▓▒▒▓▓▓▓▓▒▓▒▒▓████████████▓▒▒▒▒▒▒▒▒▒▓▓▓▓█▓▓▓▓██▓▓███▒▒▒▒▒▒▓▒▓▒▓▓░▒░▒░▒▒▒▓▒░░▒▒▓██▓▓████████████████████▓▓▓▓▓▓▓▓▓▓▓▓▓▓▒▒▒▒▒▒▒▒▒▒▒▒▒▒▒▓▓▓█▓▒▒▒▒▒▒▒▒▒▒▒▒▒▓▓▓▓
░░░░░░░░░░▒▒▒▒▒▒▒▒▒▒▒▒▓▓▓▓█▓▒▒▒▒▒▒▒▒▒▒▒░░▒▒▓▒▒▒▒▓▒▒░▒▒ ▒░▒▒░░░░  ░▒▒▒▒▓▓▓▓█▓▓▓▒▒████████▒███▓▒▒▒▒▒▒▒▓▓▓▓▓███▓▓▓▓▓▓████▒▒▒▒▒▒░▓▓▓█▒░░░░░▒▒░░░░░░░░▓▓▓▓████████████████████▓▒▓▓▓▓▓▓▓▓▓▓▓▓▒▒▒▒▒▒▒▒▒▒▒▒▒▓▓█████▒▒▒▒▒▒▒▒▒▒▒▒▒▓▓▓▓
░░░░░░░░░░▒▒▒▒▒▒▒▒▒▒▒▒▓▓▓▓█▓▓▒▒▒▒▓▒▒▒▒▒░░▒▒▒▒▒▒▒   ░░▒         ░░░▒▒▒▒▓▒▓▓▓█▓▒░▒████████▒███▓▒▒▒▓▓▓▓▓▓▓▓▓███████▓▓▓▓▓▓▒▒▒▒▒▒▒▒▓█▓▒▒▓░░░▒▓▒▓▓▓▓▓▓███▓▓████████████████████▓▒▓▓▓▓▓▓▓▓▓▓▓▓▒▒▒▒▒▒▒▒▒▒▓▓█████▓▓▓▒▒▒▒▒▒▒▒▒▒▒▒▒▓▓▓▓
░░░░░░░░░░▒▒▒▒▒▒▒▒▒▒▒▒▒▒▒▒▒▓▒▓▒▓▒▒▓▒▒▒▒░░░░░░░░░░░░░▒▒░░░░░░▒▒▒▒░░▒▒▒▒▒▒▒░▒░░░░▒████▓██▓▒▓▓▓▓▓▓▓▓▓▓▓▓▓▓▓▓██▓████▓▓▓▓▓▓▒▒▒▒▒▒▒▒▒▒▒▒▒▒▒▒▒▒▒▒▒▒▒▒▒▓▓▓▓▒▓████████████████████▓▒▓▓▓▓▓▓▓▓▓▓▓▓▓▓▒▓▒▒▒▒▒▒▒▒▒▒▒▒▒▒▒▒▒▒▒▒▒▒▒▒▒▒▒▒▓▓▓▓▓
░░░░░░░░░░░▒▒▒▒▒▒▒▒▒▒▒▒▒▒▒▒▓▓▒▓▓▓▓▒▒▒▒▒▒░▒▒▒▒▒▒▒▒░░░▒▒░▒▒░░░░░▒░░░▒▒▒▒▒▒▒▒░░░░░░░▒░▒▒▒▒▒▒▒▒▒▒▒▒▒▒▒▒▒▒▒▒▒▓█▓▓█████████▓▒▒▒▒▒▒▒▒▒▒▒▒▒▒▒▒▒▒▓▓▓▓▓▓▓▓▓▓▓▒█████████████████████▓▒▓███▓▒▒▒▒▒▒▒▒▒▒▒▒▒▒▒▒▒▒▒▒▒▒▒▒▒▒▒▒▒▒▒▒▒▒▒▒▒▒▒▓▓▓▓▓
░░░░░░░░░░░▒▒▒▒▒▒▒▒▒▒▒▓▓▒▓▓▓▓▓▓▓▓▓▓▒▒▒▓▓███▓▒▒▒▒▒▒▒▒▒▒▒▒▒▒░░░░▒▒▒▒▒▒▒▒▒▒▒▒▓░░▒▒░░▒░▒▒▒▒▒▒▒▒▒░░░░░░░▒▒▒▒▒▒▒▓██████████▓▒▒▒▒▒▒▒▒▒▒▒▒▒▒▒▒▒▓▓▓▓▓▓▓▓▓▓▓▒▒█████████████████████▓▒▓███▓▒▒▒▒▒▒▒▒▒▒▒▒▒▒▒▒▒▒▒▒▒▒▒▒▒▒▒▒▒▒▒▒▒▒▒▒▒▒▒▓▓▓▓▓
░░░░░░░░░░░▒▒▒▒▒▒▒▒▒▒▒▒▓▓▓▓▓▓▓▓▓▓▓▒▒▒▒▓▓▓▓▓▓▒▒▒▒▒▒▒▒▒▒▒▒▒▒▒▒▒▒▒▒▒▒▒▒▒▒▒▒▒▒▒▓▒▓█▓▒▒▒▒▒▒▒▒▒▒░░░░░░░░░▒▒▒▒▒▒▓▓▒▒▒▒▒▒▒▓██▒▒▒▒▒▒▒▒▒▒▒▒▒▒▒▒▒▒▒▒▒▒▒▒▒▒▒▒▓▓▓████████████████████▓▓▓▓▓▒▒▒▒▒▒▒▒▒▒▒▒▒▒▒▒▒▒▒▒▒▒▒▒▒▒▒▒▒▒▒▒▒▒▒▒▒▒▒▒▒▒▓▓▓▓▓
░░░░░░░░░░░▒▒▒▒▒▒▒▒▒▒▒▒▓▓▓▓▓▓▓▓▓▓▒▒▒▒▒▒▒░▒▒▒▒▒▒▒▒▒▒░░░░░░░░░░░░░░░▒▒▒▒▒▒▒▒▒▒▒▓▒▒▒▒▒▒▒▒▒▒▒▒▒▒▒░░░░░░▒▒▓▒▓▓▓▓▓▓▓▓▓▓▓▓▓█▓▓▓▓▓▓▓▓▓▓▓▓▓▓▓▓▓██████████████████████████████████▓▓▓▓▓▓▓▓▓▓▓▓▓▓▓▓▓▓▒▓▓▓▓▓▓▓▓▒▒▒▒▒▒▒▒▒▒▒▒▒▒▒▒▒▒▒▒▓▓▓▓▓
░░░░░▒░░░░░▒▒▒▒▒▒▒▒▒▒▒▓▓▓▓▓▓▓▓▓▓▓▒▒▒▒▒▒▒▒▒▒▒▒▒▒▒▒▒▒▒▒▒▒▒▒▒▒▒▒▒▒▒▓▓▓▓▓▓▓▓▓▓▒▒▒▒▓▓▓▓▓▓▓▓▓▒▒░░░░░░░░░░▒▒▒▒▒▒▓▓▓▓▓▓▓▓▓▓▓████████████████████████████████████████████████████▓▓▓▓▓▓▓▓▓▓▓▓▓▓▓▓▓▒▒▓▓▓▓▓▓▓▓▒▒▒▒▒▒▒▒▒▒▒▒▒▒▒▒▒▒▒▒▓▓▓▓▓
░░░░░░░░░░░▒▒▒▒▒▒▒▒▒▒▒▒▒▒▓▒▓▒▓▒▒▒▒▒▒▒▒▒▓▓▓▓▓▓▓▓▓▓▓▓▓▓▓▓▓▓▓▓▓▓▓▓▓▓▓▓▓▓▓▓▓▓▓▓▒▒▓▓▓▓▓▓▓▓▓▓▒▒░░░░░░░░░░▒▓▓▓▓▒▓█▓▓▓▓▓▓▓▓▓████████████████████████████████████████████████████▓▓▓▓▓▓▓▓▓▓▓▓▓▓▓▓▓▒▒▓▓▓▓▓▓▓▓▓▒▒▒▒▒▒▒▒▒▒▒▒▒▒▒▒▒▒▒▒▒▒▒▒
░░░░░░░░░░░▒▒▒▒▒▒▒▒▒▒▒▒▒▒▒▒▒▒▒▒▒▒▒▒▒▒▓▓▓▓▓▓▓▓▓▓▓▓▓▓▓▓▓▓▓▓▓▓▓▓▓▓▓▓▓▓▓▓▓▓▓▓▓▓▓▓▓▓▓▓▓▓▓▓▓▒▓▒░░░░░░▒▒▒▒▒▓▓▓▓▓▓█▓▓▓█▓▓▓▓▓█▓█████████████████████████████▓█▓█▓█▓▓▓▓▓▓▓▓▓▓▓▓▓▓▓▓▒▒▓▓▓▓▓▓▓▓▓▓▓▓▓▓▒▒▓▓▓▓▓▓▓▓▓▒▒▒▒▒▒▒▒▒▒▒▒▒▒▒▒▒▒▒▒▒▒▒▒
░░░░░░░░░░░░▒▒▒▒▒▒▒▒▒▒▒▒▒▒▒▒▒▒▒▒▒▒▒▒▒▒▓▓▒▒▒▓▓▓▓▓▓▓▓▓▓▓▓▓▓▓▓▓▓▓▓▓▓▓▓▓▓▓▓▓▓▓▓▓▓▓▓▓▓▓▓▓▓▓▒▒▒▒▒▒▒▒▒▒▒▒▒▒▒▒▓▓▓▓▓▓▓▓▓▓▓▓▓▓▓▓▓▓▓▓▓▓▓▓▓▓▓▓▓▓▓▓▓▓▓▓▓▓▓▓▓▓▓▓▓▓▓▓▓▓▓▓▓▓▓▓▓▓▓▓▓▓▓▓▓▒▒▓▓▓▓▓▓▓▓▓▓▓▓▓▓▓▓▒▒▓▓▓▓▓▓▓▒▓▒▒▒▒▒▒▒▒▒▒▒▒▒▒▒▒▒▒▒▒▒▒▒▒
░░░░░░░░░░░░▒▒▒▒▒▒▒▒▒▒▒▒▒▒▒▒▒▒▒▒▒▒▒▒▒▒▒▒▒▒▓▒▓▓▒▓▒▓▒▒▒▒▒▒▒▒▒▒▒▒▒▒▒▓▒▓▓▒▒▒▒▒▒▒▒▒▒▒▒▒▒▒▒▒▒▒▒▒▒▒▒▒▒▒▒▒▒▒▒▒▒▒▒▒▒▒▒▒▒▒▒▒▒▒▒▒▒▒▒▒▒▒▒▒▒▓▓▒▒▒▒▒▒▒▒▒▒▒▒▒▓▒▒▒▒▒▒▒▒▒▒▒▒▒▒▒▒▒▒▒▒▒▒▒▒▒▒▒▓▓▓▓▓▓▓▓▓▓▓▓▓▓▓▒▒▓▓▓▓▓▓▒▓▒▒▒▒▒▒▒▒▒▒▒▒▒▒▒▒▒▒▒▒▒▒▒▒▒
░░░░░░░░░░░░▒▒▒▒▒▒▒▒▒▒▒▒▒▒▒▒▒▒▒▒▒▒▒▒▒▒▒▒▒▒▒▒▒▒▒▒▒▒▒▒▒▒▒▒▒▒▒▒▒▒▒▒▒▒▒▒▒▒▒▒▒▒▒▒▒▒▒▒▒▒▒▒▒▒▒▒▒▒▒▒▒▒▒▒░░▒▒▒▒▒▒▒▒▒▒▒▒▒▒▒▒▒▒▒▒▒▒▒▒▒▒▒▒▒▒▒▒▒▒▓▓▓▒▒▒▒▒▒▒▒▒▒▒▒▒▒▒▒▒▒▒▒▒▒▒▒▒▒▒▒▒▒▒▒▒▒▒▒▓▓▓▓▓▓▓▓▓▓▓▓▓▒▒▒▓▓▓▓▒▓▒▒▒▒▒▒▒▒▒▒▒▒▒▒▒▒▒▒▒▒▒▒▒▒▒▒▒
░░░░░░░░░░░░░░░░░░░░░░░░▒▒▒▒▒▒▒▒▒▒▒▒▒▒▒▒▒▒▒▒▒▒▒▒▒▒▒▒▒▒▒▒▒▒▒▒▒▒▒▒▒▒▒▒▒▒▒▒▒▒▒▒▒▒▒▒▒▒▒▒░░░░░░░░░░░░░░░░░░░▒▒▒▒▒▒▒▒▒▒▒▒▒▒▒▒▒▒▒▒▒▒▒▒▒▓▓█▒▓▓█▓▒▒▒▒▒▒▒▒▒▒▒▒▒▒▒▒▒▒▒▒▒▒▒▒▒▒▒▒▒▒▒▒▒▒▒▓▓▓▓▓▓▓▓▓▒▒▒▒▒▒▒▒▒▒▒▒▒▒▒▒▒▒▒▒▒▒▒▒▒▒▒▒▒▒▒▒▒▒▒▒▒▒▒▒
░░░░░░░░░░░░░░░░░░░░░░░░░░░░░░░░░░░░░░░░░░░░░░░░░░░░░░░░░░░░░░░░░░░░░░░░░▒░░░░░░░░░░░░░░░░▒▒▒▒▒▒▒▒▒▒▓▓▓▓▓▓▓▓▓███████████████████▓███▒▒▓█▒▒▒▒▒▒▒▒▒▒▒▒▒▒▒▒▒▒▒▒▒▒▒▒▒▒▒▒▒▒▒▒▒▒▒▒▒▒▒▓▒▓▒▓▓▓▓▓▒▒▒▓▓▓▓▓▓▒▒▒▒▒▒▒▒▒▒▒▒▒▒▒▒▒▒▒▒▒▒▒▒▒▒▒
░░░░░░░░░░░░░░░░░░░░░░░░░░░░░░░░░░░░░░░░░░░░░░░░░░░░░░░░░▒▒▒▒▒▒▒▒▒▒▓▓▓▓▓▓▓▓▓▓▓▓▓▓▓▓▓▓▓▓▓▓▓▓▓▓████████████████████████████████████████▓▓▓▒▒▒▒▒▒▒▒▒▒▒▒▒▒▒▒▒▒▒▒▒▒▒▒▒▒▒▒▒▒▒▒▒▒▓▓▓▓▓▓▓▓▓▓▓▓▓▓▒▒▓▓▓▓▓▓▒▒▒▒▒▒▒▒▒▒▒▒▒▒▒▒▒▒▒▒▒▒▒▒▒▒▒▒
░░░░░░░░░░░░░░░░░░▒▒▒▒▒▒▒▒▒▒▒▒▓▓▓▓▓▓▓▓▓▓▓▓▓▓▓▓▓▓▓▓▓▓▓▓▓▓▓▓▓▓▓▓▓▓▓▓▓█▓████████████████████████████████████████████████████████████▓██▓▒▒▒▒▒▒▒▒▒▒▒▒▒▒▒▒▒▒▒▒▒▒▒▒▒▒▒▒▒▒▒▒▒▒▒▒▒▓▓▓▓▓▓▓▓▓▓▓▓▓▓▒▒▒▓▓▒▓▒▒▒▒▒▒▒▒▒▒▒▒▒▒▒▒▒▒▒▒▒▒▒▒▒▒▒▒▒
░░░░░░░░░░░░░░░░▒▒▓▓▒▒▒▒▒▒▒▒▓▓▓▓▓▓▓▓▓▓▓▓▓▓▓▓▓▓▓▓▓▓▓▓▓▓▓▓▓▓▓▓▓▓▓▓▓▓▓▓▓█▓██████████████████████████████████████████████████████████▓██▓▒▒▒▒▒▒▒▒▒▒▒▒▒▒▒▒▒▒▒▒▒▒▒▒▒▒▒▒▒▒▒▒▒▒▒▒▒▓▓▓▓▓▓▓▓▓▓▓▓▓▓▒▒▓▓▒▓▒▒▒▒▒▒▒▒▒▒▒▒▒▒░▒▒▒▒▒▒▒▒▒▒▒▒▒▒▒