▒▒▒▒▓▓▓▓▓▓▓▓▓▓▓▓▓▓▓▓▓▓▓██████████████████████████████████████████████▓▓▓▓▓▓▓▓▓▓▓▓▓▓▓▓▓▓▓▓▓▓▓▓▓▓▓▓▓▓▓▓▓▓████████████████████████████████████████████████████████████████████████████████████▓▓▓▓▓▓▓▓▓▓▓▓▓▓▓▓▓▒▒▒▒▒▒▒▒▒▒▒▒▒▒▒▒
▒▒▒▒▒▒▓▒▓▓▓▓▓▓▓▓▓▓▓▓▓▓▓▓▓▓▓███████████████████████████████████████████▓█▓█▓▓▓▓▓▓▓▓▓▓▓▓▓▓▓▓▓▓▓█████████████████████████████████████████████████████████████████████████████████████████████▓█▓▓▓▓▓▓▓▓▓▓▓▓▓▓▓▓▓▒▓▒▓▓▒▒▒▒▒▒▒▒▒▒
▒▒▒▒▒▒▒▒▒▒▓▓▓▓▓▓▓▓▓▓▓▓▓▓▓▓▓▓███████████████████████████████████████████▓█▓▓▓▓▓▓▓▓▓▓▓▓▓▓▓▓▓▓▓▓█████████████████████████████████████████████████████████████████████████████████████████████▓▓▓▓▓▓▓▓▓▓▓▓▓▓▓▓▓▓▓▓▓▒▒▒▒▒▒▒▒▒▒▒▒▒
▒▒▒▒▒▒▒▒▒▒▒▒▒▒▓▓▓▓▓▓▓▓▓▓▓▓▓▓▓▓▓███████████████████████████████████████▓█▓█▓▓▓▓▓▓▓▓▓▓▓▓▓▓▓▓▓████████████████████████████▓▓█████████████████████████████████████████████████████████████████▓█▓▓▓▓▓▓▓▓▓▓▓▓▓▓▓▓▒▒▒▒▒▒▒▒▒▒▒▒▒▒▒▒
▒▒▒▒▒▒▒▒▒▒▒▒▒▒▒▒▒▓▓▓▓▓▓▓▓▓▓▓▓▓▓▓▓▓██████████████████████████████████████▓█▓▓▓▓▓▓▓▓▓▓▓▓▓▓▓▓██████████████████████████████████████████████████████████████████████████████████████████████████▓▓▓▓▓▓▓▓▓▓▓▓▓▓▓▓▒▒▒▒▒▒▒▒▒▒▒▒▒▒▒▒
▒▒▒▒▒▒▒▒▒▒▒▒▒▒▒▒▒▒▒▒▒▓▓▓▓▓▓▓▓▓▓▓▓▓▓▓██████████████████████████████████▓▓█▓█▓▓▓▓▓▓▓▓▓▓▓▓▓▓████████████████████████████████████████████████████████████████████████████████████████████████████▓▓▓▓▓▓▓▓▓▓▓▓▓▓▓▒▒▒▒▒▒▒▒▒▒▒▒▒▒▓▓
▒▒▒▒▒▒▒▒▒▒▒▒▒▒▒▒▒░▒▒▒▒▒▒▒▒▓▓▓▓▓▓▓▓▓▓▓▓▓████████████████████████████▓▓▓█▓▓▓▓▓▓▓▓▓▓▓▓▓▓▓█████████████████████████████████████████████████████████████████████████████████████████████████████▓▓▓▓▓▓▓▓▓▓▒▒▒▓▓▓▒▒▒▒▒▒▒▓▓▓▓▓▓▓▓▓▓
▒▒▒▒▒▒▒▒▒▒▒▒▒▒▒▒▒▒▒▒░▒░▒▒▒▒▒▒▒▒▒▓▓▓▓▓▓▓▓▓▓▓████████████████████████▓▓▓▓▓▓▓▓▓▓▓▓▓▓▓▓███████████████████████████████████████████████████████████████████████████████████████████████████████▓▓▓▓▓▓▓▓▓▒▒▒▒▒▒▓▓▓▓▓▓▓▓▓▓▓▓▓▓▓▓▓▓▓
▒▒▒▒▒▒▒▒▒▒▒▒▒▒▒▒▒▒▒▒▒▒░▒▒▒░▒▒▒▒▒▒▒▓▓▓▓▓▓▓▓▓▓▓▓▓▓██████████████████▓█▓▓▓▓▓▓▓▓▓▓▓▓██████████████████████████████████████████████████████████████████████████████████████████████████████████▓▓▓▓▓▓▓▓▓▓▓▓▓▓██▓█▓▓█▓▓▓▓▓▓███████
░▒▒▒▒▒▒▒▒▒▒▒▒▒▒▒▒▒▒▒▒▒▒▒▒▒▒▒▒▒▒▒▒▒▓▓▓▓▓▓█▓▓▓▓▓▓▓▓▓▓▓▓████████████▓▓▓▓▓▓▓▓▓▓▓▓▓██████████████████████████████████████████████████████████████████████████████████████████████████████████▓▓▓▓▓██████████████████████████▓▓▓▓▓
░▒▒▒▒▒▒▒▒▒▒▒▒▒▒▒▒▒▒▒▒▒▒▒▒▒▒▒▒▓▒▒▒▒▓▓▓▓▓▓▓▓▓▓▓▓▓▓▓▓▓▓▓▓▓▓▓▓██████▓▓▓▓▓▓▓▓▓▓▓▓▓▓████████████████████████████████████████████████████████████████████████████████████████████████████████████████████████████████████▓▓▓▓▓▓▓▓▓▓
░▒▒▒▒▒▒▒▒▒▒▒▒▒▒▒▒▒▒▒▒▒▒▒▒▒▒▒▓▒▓▓▓▓▓▓▓▓▓▓▓▓▓▓▓▓▓▓▓▓▓▓▓▓▓▓▓▓▓▓▓▓▓▓▓▓▓▓▓▓▓▓▓▓▓▓▓▓█████████████████████████████████████████████████████████████████████████████████████████████████████████████████████████████▓▓▓▓▓▓▓▓▓▓▓▒▒▒▒▒▒
░▒▒▒▒▒▒▒▒▒▒▒▒▒▒▒▒▒▒▒▒▒▒▒▒▒▒▒▒▒▓▒▓▓▓▓▓▓▓▒▓▓▓▓▓▓▓▓▓▓▓▓▓▓▓▓▓▓▓▓▓▓▓▓▓▓▓▓▓▓▓▓▓▓▓▓▓█████████████████████████████████████████████████████████████████████████████████████████████████████████████████████████▓▓▓▓▓▓▓▒▒▒▒▒▓▓▓▓▓▓▓▓▓▓
░▒▒▒▒▒▒▒▒▒▒▒▒▒▒▒▒▒▒▒▒▒▒▒▒▒▒▒▒▒▒▒▒▒▒▓▓▓▓▓▓▓▓▓▓▓▓▓▓▓▓▓▓▓▓▓▓▓▓▓▓▓▓▓▓▓▓▓▓▓▓▓▓▓▓███████████████████████████████████████████████████████████████████████████████████████████████████████████████████▓▓▓▓▓▓▒▒▒▒▓▓▓▓▓▓▓▓▓▓▓▓▓▓▓▓▓▓▓▓
░▒▒▒▒▒▒▒▒▒▒▒▒▒▒▒▒▒▒▒▒▒▒▒▒▒▒▒▒▒▒▒▒▒▒▒▒▒▒▓▓▓▓▓▓▓▓▓▓▓▓▓▓▓▓▓▓▓▓▓▓▓▓▓▓▓▓▓▓▓▓▓▓▓████████████████████████████████████████████████████████████████████████████████████████████████████████████▓▓▓▓▓▓▓▓▓▓▓▓▓▓▓▓▓▓▓▓▓█████████████████
░▒▒▒▒▒▒▒▒▒▒▒▒▒▒▒▒▒▒▒▒▒▒▒▒▒▒▒▒▒▒▒▒▒▒▒▒▒▒▒▒▒▒▒▓▓▓▓▓▓▓▓▓▓▓▓▓▓▓▓▓▓▓▓▓▓▓▓▓▓▓▓▓▓▓▓██████████████████████████████████████████████████████████████████████████████████████████████████▓▓▓▓▓▓▓▓▓▓▓▓▓▓▓▓▓█████████████████████████████
░▒▒▒▒▒▒▒▒▒▒▒▒▒▒▒▒▒▒▒▒▒▒▒▒▒▒▒▒▒▒▒▒▒▒▒▒▒▒▒▒▒▒▒▒▒▒▒▒▒▒▒▒▓▓▓▓▓▓▓▓▒▒▒▒▓▓▓▓▓▓▓▓▓▓▓███▓▓▓███████████████████████████████████████████████████████████████████████████████████▓▓▓▓▓▓▓▓▓▓▓▓▓▓█████████████████████████████████████████
░░▒▒▒▒▒▒▒▒▒▒▒▒▒▒▒▒▒▒▒▒▒▒▒▒▒▒▒▒▒▒▒▒▒▒▒▒▒▒▒▒▒▒▒▒▒▒▒▒▒▒▒▒▒▒▒▒▒▒▒▒▒▒▒▓▓▓▓▓▓▓▓▓▓▓▓▓▓▓▓▓▓█████████████████████████████████████████████████████████████████████████▓▓▓▓▓▓▓▓▓▓▓▓████████████████████████████████████████████████████
░░▒░▒▒▒▒▒▒▒▒▒▒▒▒▒▒▒▒▒▒▒▒▒▒▒▒▒▒▒▒▒▒▒▒▒▒▒▒▒▒▒▒▒▒▒▒▒▒▒▒▒▒▒▒▒▒▒▒▒▒▒▓▓▓▓▓▓▓▓███████████▓▓▓▓▓█████████████████████████████████████████████████████████████▓▓▓▓▓▓▓▓██████████████████████████████████████████████████████▓▓▓▓▓▓▒▒▒▒
░░▒▒▒▒▒░░▒▒▒▒▒▒▒▒▒▒▒▒▒▒▒▒▒▒▒▒▒▒▒▒▒▒▒▒▒▒▒▒▒▒▒▒▒▒▒▒▒▒▒▒▒▒▒▒▒▒▒▒▓▓▓▓███████████████████████████████████████████████████████████████████████████▓▓▓▓▓████████████████████████████████████████████████████▓▓▓▓▓▓▓▓▓▓▓▓▓▓▓▓▓▒▒▓▒▒▒
▒░▒▒▒▒▒░░░░░░░░░░░▒▒▒▒▒▒▒▒▒▒▒▒▒▒▒▒▒▒▒▒▒▒▒▒▒▒▒▓▒▓▓▓▓▓▓▓▓▓▓▓▓▓▓▓▓█████▓▓▓▓▓▓███████████████████████████████████████████████████████████████████████████████████████████████████████████████████████▓▓▓▓▓▓▓▓▓▓▓▓▓▓▓▓▓▓▓▓▓▓▒▓▒▓▒
▒░▒▒▒▒▒▒░░░░░░░░▒░▒▒▒▒▒▒▒▒▒▒▒▒▒▒▒▒▓▓▓▓▓▓▓▓▓▓▓▓▓▓▓▓▓▓▓▓▓████████████████████████████▓▓▓███████████████████████████████████████████████████████████████████████████████████████████████████████████▓▓▓▓▓▓▓▓▓▓▓▓▓▓▓▓▓▓▓▓▓▓▓▓▓▓▓
▓▓▓▒▒▒▒▒▒░▒▒░▒▒░░▒▒▒▒▒▒▒▒▒▒▒▒▒▒▒▒▒▒▒▒▒▒▒▓▓▓▓▓▓▓▓▓██████████████████████████████████████████████████████████████████████████████████████████████████████████████████████████████████████████████████▓▓▓▓▓▓▓▓▓▓▓▓▓▓▓▓▓▓▓▓▓▓▓▓▓
░░▒▒▒▒▒▒▒▒▒▒▒▒▒▒▒▒▒▒▒░░░░░░░░░░░░░░░░░▒▒▒▒▒▒▒▒▒▒▒▒▒▒▓▓▓▓▓▓▓█████████████████████████████████████████████████████████████████████████████████████████████████████████████████████████████████████████▓█▓▓▓▓▓▓▓▓▓▓▓▓▓▓▓▓▓▓▓▓▓▓
░░▒▒▒▒▒▒▒▒▒▒▒▒▒▒▒▒▒▒▒░░░░░░░░░░░░░░░░░░░░░░░░░░░░░▒▒▒▒▒▒▒▒▒▒▒▒▓▓▓▓▓▓▓▓██████████████████████████████████████████████████████████████████████████████████████████████████████████████████████████████████▓▓▓▓▓▓▓▓▓▓▓▓▓▓▓▓▓▓▓▒
░░▒▒▒▒▒▒▒▒▒▒▒▒▒▒▒▒▒▒▒░░░░░▒▒▒▒▒▒▒▒░░░▒░▒▒▒▒▒▒▒▒▒▒▒▒▒▒▒▒▒▒▒▒▒▒▒▒▒▒▒▒▒▒▒▒▒▒▒▒▒▒▒▒▒▒▓▓▒▒▓▓▓▓████████████████████████████████████████████████████▓██████████████████████████████████████████████████████▓▓▓▓▓▓▓▓▓▓▓▓▓▓▓▓▓▓▓▒▒▒░░
░░░▒▒▒▒▒▒▒▒▒▒▒▒▒▒▒▒▒▒░░░░░▒▒░░░░░░▒▒▒▒▒▒▒▒▒▒▒▒▒▒▒▒▒▒▒▒▒▒▒▓▒▓▓▓▓▓▓▓▓▓▓▓▓▓▓▓▓▓▓▓▓▓▓▓▓▓▓▒▒▒▓███████████████▓██████▓▓█████████████████████████████████████████████████████████████████████████████▓▓▓▓▓▓▒▒▒▒▒▒▒░░░░░░░░░░██▒▒░  
░░░▒▒▒▒▒▒▒▒▒▒▒▒▒▒▒▒▒▒▒▒░░░▒▒░░░░▒▒▒░░░░░░░░░▒▒▒▒▒▒▒▒▓▓▓▓▓▓▓▓▓▓▓▓▓█▓███████████████████▓▓███████████████████████▓▓▓███████████▓▓▓▓▒▓▓▓▓▓▓██▓██▓████████████████████████████████████████████▓▒▒▒▒▒▒▒▒▒▒▒▒░░░░▒░░▒▒▓▓▒▓▒█▓▒▒   
░░░▒▒▒▒▒▒▒▒▒▒▒▒▒▒▒▒▒▓▒▒░░░▒▒▒░▒▒▒▒▒░░░░░▒░░▒▒▒▒▒▒▒▓▓▓▓▓▓▓▓▓▓▓▓▓████████████████████████▓██████████████████████████████████▓██▓▓▓██▓▓▒▒▓███▓██▓████████████████████████████████████████████▓▓▒▒███▓▓▒▒▒▒▓███▒░░▓█▓▓▓▓▒█▓▒░   
░░░▒▒▒▓▓▒▒▒▒▒▒▒▒▒▒▒▒▓▒▒▒░░▒▒▒░▒▒▒▒▒▒▒▒▒▒▒▒▒▒▒▒▒▒▒▓▓▓▓▓▓▓▓▓▓▓▓▓▓████████████████████████▓█████████████████████████████████▓▓████████████▒▒▒▒▒▓▓████████████████████████████████████████████▓▒▒████▒░░▒▒███▓▒░░▓████▓▓▒█▒▒░   
░░░▒▒▒▓▒▒▒▒▒▒▒▒▒▒▒▒▒▓▒▒▒░▒▒▒▒▒▓▓▓▓▓▒▒▒▒▒▒▒▒▒▒▒▒▒▒▓▓▓▓▓▓▓▓▓▓▓▓▓█▓▒▒▓████████████████████▓███████████████████████▓▓█████████▓▓███████████▓████▓▓████████████████████████████████████████████▓▓▒██▓▒▒▒░▓▓▓▒▒▒▒▒▒▒▒▓▓▓▓▒▒█▒▒░  ░
░░░▒▒▒▒▒▒▒▒▒▒▒▒▒▒▒▒▒▓▒▒▒░░▒▒▒▓▓▓▓█▓▒▒▒▒▒▓▓▒▒▒▒▒▒▒▓▓▓▓▓▓▓▓▓▓▓▓██▓▓▓▓█████████████████▓██▓███████████████████████▓███▓██▓▓█▓▓█▒█████▓▓███▒▒█▒▒▓▓████████████████████████████████████████████▓▓░▒▒▒▒▓▓▒░░░░░░░░░░░░░░░░▒█▒░░  ▒
░░░▒▓▒▒▓▒▒▒▒▒▒▒▒▒▒▒▒▓▒▒▒▒▒▒▒▒▒▓▓▓█▓▒▒▒▒▓▒▒▓▒▒▒▒▒▒▓▓▓▓▓▓▓▓▓▓▓▓███▓▓▓████████████████████▓▓██████████████████████▓███▓██▓▒▓▓▓▓▒█████████▓▒▓█▓▒▓▓████████████████████████████████████████████▓▒░▓███▓█▒▒▓██▓▓▒▒██▒▒▒▒▒▒▓▓▒░░   
░░░▒▓▒▒▒▒▒▒▒▒▒▒▒▒▒▒▒▓▒▒▒▒░▒▒▒▒▒▒▒▒▒▒░▒▒▒▒▒▒▒▒▒▒▒▒▓▓▓▓▓▓▓▓▓▓▓▓▓█████████████████████████████████▓▓▓▓▓▓▓▓▓███████▓▓▓▓▓██▓███▓▓▓█████▓███▓▓▓▓▓▓▓▓███████████████████████████████████████████▓█▒▒█████▒░▒████▓░▒██▓▓▓▓▓▓█▓▒▒    
░░░▒▓▒▒▒▒▒▒▒▒▒▒▒▒▒▒▒▓▓▒▒▒░▒▒▒▒▒▒▒▒▒▒░▒▒▒▒▒▒▒▒▒▒▒▒▓▓▓▓▓▓▓▓▓▓▓▓██████████████████████████▓███████▓▓▓▒▒▒▒▓▒▓▓█████▓▓▓▓▓▓▓▓▓██████████████▓▓█▓▓█▓▓███████████████████████████████████████████▓█▒▒▓▓▓▓▓░░░▒▓██▒░▒███████▒█▓▒░    
░░░▒▓▒▓▒▒▒▒▒▒▒▒▒▒▒▒▒▓▓▒▒▒░▒▒▒▒▒▒▒▒▒▒░░░░░░▒▓▓▒▓▒▒▓██▓▓▓▓▓▓▓▓▓▓██████████████████████▓█▓▒▓███████▓▓▓▓▒▒▒▒░░▒████▓▓▓▓▓▓▓▓▓▓▓▓██████▓███▓▓▓█▓▒▓▓▓███████████████████████████████████████████▓█▒░▒░▒░▒▒░░░░▒░░▒░░░▒▒▒▒███▒▒░ ░░░
▒▒░▒▓▒▓▓▓▒▒▒▒▒▒▒▒▒▒▒▓▓▒▒▒░▒▒▒▒▒▒▒▒▒▒░░░░░░▒▒▓▓▒▒▒▓▓▓▓▓▓▓▓▓▓▓▓▓██████████████▒▒▓█████▓▓▓▓▓▓█▓▓▓▒▒▒▒░▒▒▓▓▓████████▓▓█████████▓▒▒▒▓▓▓▓▓▓▓▓▓▓███▓▓███████████████████████████████████████████▓▓░▒████▓▓░▒▓▓▓▓▒░░░░░░░░░░█▒░░    
▒░░▒▓▓▓▓▓▓▒▒▒▒▒▒▒▒▒▒▓▓▒▒▒░░▒▒▒▒▒▒▒▒▒░░░░▒▒▓▓▓▒▒▒▒▓▓▓▓▓▓▓▓▓▓▓▓▓▓██▓▓▓▒▒▒▒████▓▓▓▓███████████████████████████▓▓▒▓▓▓▓▓▓█████████▓▓▓█████████▓▒▒▒▓██████████████████████████████████████████▓▓▓░▓████▓▒░▓███▓█░░▒▒██▒▒ ░▓▒░░    
▒▒░░▓▓▓▓▓▓▒▒▒▒▒▒▒▒▒▒▓▓▒▒▒░▒▒▒▒▒▒░░░░░░░░▒▒▒▒▒▒▒▒▒▓▓▓▓▓▓▓▓▓▓█▓▒▒▓▓▓▓▒▒░░▒██████████████████████████████████▓▓▓▒▓▓▓▓▒▓▓▒▒▓▓▒▓▓▓▓▓▓███████████████████████████████████████████████████████▓▓▓▓▒█▓█▓█▓░▒█████▓░▒█████▒░▒▓▒░░    
▒▒░░▓▓▓▓▓▓▒▒▒▒▒▒▒▒▒▒▓▓▒▒▒░░▒▒▒▒░░▒▒▒▒▒▒▒▒▒▒▒▒▒▒▒▒▒▒▒▒░░▓▓▓▒▒░░  ░░░░  ░▒████████████████▓█████████████████████▓▓▒▓▒▒▓▒▒███▓▒▓▓▒▓▓▒▒▒▒▒▓▓█▓█████████████████████████████████████████████▓▓▓█░░░░░░▓░░░▒▓██▒░░▒███▓░░▓▓▒░░    
▒▒░░▓▓▒▓▓▓▒▒▒▒▒▒▒▒▒▒▓▓▒▒▒░░▒▒▒▒▒▒▒▒▒▒▒▒▒▒▒▒▒▒▒▒▒▒▒▒▒░░░ ░░░░          ░▒▓███████████████▓███████████████████████▓▓▒▓▒▒▒▒▒▒▒▒▓▒▒▓▒▒▒▒▒▒▓█▓▓▓▒▒▓▓█▓▓▓▓▓▓▓█████▓██████████████████████████▓▓█▒░░░░ ░▒▒░▒░  ░░▒▓▓▒▒▓░▒▓█▓▒▒     
▒▒░░▒▓▒▓▓▓▓▒▓▒▓▒▓▒▒▒▓▓▒░░░░▒▒▒▒▒▒▒▒▒▒▒▒▒▒▒▒▒▒▒▒▒░░░░░░                ░░▓███████████████▓████▓▓██████▓▒▒▒▒▒▓▓▓▒▒▒▒▒▒▒▒▒▒▒▒▒▒▒▒▒▒▒▒▒▒▒▒▓█▓▓▒▒▒▓▓▓▒▒▒▒▒▒▒▓▓▒▓▓▓▓▓▓▓▓█▓▓▓▓▓███████████████▓▓█▒▓▓▒▒▓▓░░▓█▒ ░▓▒████▒▓▓▓▒▓▓▒░ ░░░░
▒░░░▒▓▒▓▓▓▓▒▒▒▒▒▒▒▒▒▓▓▒░░░░░░▒▒▒▒▒▒▒▒▒▒▒▒▒▒▒▒▒░░░░░░░░                ░░▓████████████████▓█▓▓▓▓██▓▓██▒▒▒▒█▓▓▓▒▒▒▒▓▓▒▒▒▓▒▒▒▒▒▒▒▒▒▓▓▓▓▓████████████████████▓▓▒▒▒▒▒▒▓▒▒▒▒▒▒▒▒▒█▓▓▓▓▓▓█▓███▓▓█▓▒▒▓▓▓▒░▒▒▒▒▒██▒███▒▓██▓▒▓▒░▒░░░░░
▒▒▒░▒▓▒▓▓▓▓▒▒▒▒▒▒▒▒▒▒▒░░░░░░░▒▒▒▒▒▒▒▒▒▒▒▒▒▒▒▒▒░░░░░░░░                ░░▓████████▓▓▒▒▒▒▒▒▒▒▒▒▒▒▒▒▒▒▒▓▓▒▒▓▓▓▓▒▒▒▓▓████▓▓▒▒▒▒▒░░▒▒▒▒▒▒▓▓█████████████████████████▓▓▒▒▒▒▒▒▒▒▒▓▓▒▒▒▒▒▒▒▓▒▓▒▒▒█░      ░░░▒▒░░▒▓▓▓▓▒▓▓█▓▒▓▒░░ ░░░▒
░░░░▒▓▓▓▓▓▒▒▒▒▒▒▒▒▒▒▒░░░░░░░░▒░▒▒▒▒▒▒▒▒▒▒▒▒▒▒▒░░░░░░░░                 ░░▒▒▒▒▒▒▒▒▒▒▒▒▒▒▒▒▒▓▓▓▓▓▓▓▓▒▓▓▓▒▒▓▓▓▓▒▒▒▒▒▓▓▒▒▓▒▒▒▒▒▒░░░▒▒▒▒▒▒▒▒▒▒▓█████████████████████████▓▓▓▓▓▒▒▓▒▒▒▒▒▒▒▓▒▓▒▒▒▓█░██▓▓█▓▓▒▒░ ░▒▒░░ ░░░░░▒▒▓▒░░     
░░░░▒▓▓▓▒░░░░░░░░░░░░░░░░░░░░▒░░░▒▒▒▒▒▒▒▒▒▒▒▒▒▒░░░░░░░          ░░░░░░░░░░▒▒█▓▒▒▒▒▓▓▓▓▓▓▓▓▒▓▒▒▓▒▓▓▓▓▓▓▒▒▓▓████████████████▒▒░░░▒▒▒▒▓█▓▓█▓▓▓▓▒▒▒▒▒▒▒▓▓▓█████▓▓▒▒▓▒▒▒▒▒▒▒▒▒▒▓▒▒▓▒▒▒▓██▓▓▒▒▓▓▒█▓▒▓██▓████████░░  ▒▒░ ▒▒▒░░     
░░░░░▓▒▒░░░░░░░░░░░░░░░░░░░░░░░░░░░░░▒▒▒▒▒▒░░░░░░░░░░░░░░░░░░░░░░░░░▒▒▒▒▒▒██▒▒▓▒▓▓▓▓▓▒▒▒▒▒▒▓▒▒▒▒▒▒▒▒████████████████████████████▒▒▒▓░▒▒▓▒▒▒▒░▒▒▒▒▒░▒▒▒▒▒▓▒▒▓▓▓▒▓▒▒▒▒▒░▒▒▒▒▓▒▒▒▒▒▒▒▓░░▒▒▒▓█▓▒▒▒▓░░███▒▒███░▒▒░░▒██▓▒▒▒▒▒▒▒▒▒░
░░░░░▒▒░░▒░░░░░░░░░░░░░░░░░░░░░░░░░░░░░░░░░░░░░░░░░░░░░░░░░░░░░░░▒▒▒▒▒▒▒▒▓██▓▓▓▓▒▓▓▓▒▒▒▒▒▒▒▒▒▒▒▒▒▒█████████████████████████████████▒▒▒▒▒░░▒░░▒█▓▒▒░▒▒▒░▒░▒░░░░░░▒▒▒▒▒▒▒▒▒▒▒▒▒▒▒▒▒▒▒▒▒▒▒▒▒▒      ░░░▒▒▒▒▒░▒▒░░▓▓██▒▒▓▒▒▒▒▒▒▒▒
░░░░░▒▒░░░░░░░░░░░░░░░░░░░░░░░░░░░░░░░░░░░░░░░░░░░░░░░░░░░░░░░░░▒▒▒▒▒▒▒▒▒▓██▒▓▓▓▓▒▓▒▒▒▒▒▒▒▒▒▒▒▒░░▓███████████████████████████████████▓▓▒▒▒▒▒▒██▒▒▒░▒▒▒▒▒▒▒▒▒▒░░░░░▒▒▒▓▒▓▓▓▓▒▒▒▒▒▒▒▒▒▒░▒▒▒▒░░▒░░   ▒▓▒▒░░░▒▒▓█▓▓▓█▒▓▒▒▒▒▒▒▒▒▒
░░░░░▒▒░░░░░░░░░░░░░░░░░░░░░░░░░░░░░░░░░░░░░░░░░░░░░░░░░░░░░░░░░░▒▒▒▒▒▒▒▒▒▓█▒▓▓▓▓▒▒▓▒▒▒▒▒▒▒▒▒▒▒▒▒▒█████████████████████████████████▓█▓▓▓▒▓▓▓██▒▒▒▒░░▒▒▒░▒▒▒▒▒▒▒▒▒▒▒░▒▒▒▒▓▓▓▓▓▓▓▒▒▒▒▒▒░▒▒▓▒▒░▒▓░░░░▓█████▒▒██▓▓▒▓▓▓▓▓▒▒▒▒▒▒▒▒
░░░░░▒▒░░░░░░░░░░░░░░░░░░░░░░░░░░░░░░░░░░░░░░░░░░░░░░░░░░░░░░▒▒▒▒▒▒▒▒▒▒▒▒▒▒▒▓▒▓▓▓▓▒▓▒▒▒▒▒▒▒▒▒▒▒▒▒▒▒▒█████████████████████████████▓▒▒▒▒▒▒▒▒░▒█▒░▒▒▒░░▒░░░░░░░░░░▒▒█▓▒▒▒▒▒▒░░▒▒▒▒▒░░▒▒▒░▒▒░      ░▒░▒▓████▒▓▓████▓▓▒▓▒▒▒▒▒▓▓▓▒
░░░░ ▒▒░░░░░░░░░░░░░░░░░░░░░░░░░░░░░░░░░░░░░░░░░░░░░░░░░░░▒▒▒▒▒▒▒▒▒▒▒▒▒▒▒▒▒▒▒▓▓▓▓▓▒▒▒▒▓▒▒▒▒▒▓▓█████▓▓▒▒▓▓███████████████████▓▒▒▒▒▒▒▒▒▒▒▒▒▒▒▓▒░░░░░░░░▒▒▓▒▒▒▒▒▒▓█▓▒▒▒▒▒▒▒▒▒░▒▒▒▒▒▒▒▒▒░░░░▒▒▒▒▒        ░░▒▒▓▓▓████▓▒▒▒░▒▒▒▒▒▒▒
░░░░░░▒░░░░░░░░░░░░░░░░░░░░░░░░░░░░░░░░░░░░░░░░░░░░░▒░▒░▒▒▒▒▒▒▒▒▒▒▒▒▒▒▒▒▒▒▒▒▒▒▓▓▓▓▒▒▒▒▒▒▒▒▒▒▒▒▒▒▒▒▒▒▒▓▓▓████▓▒▒▒▒▒▒▒▒▒▒▒▒▒▒▒▒▒▒▒▒▒▒▒▒▒▒▒▒▒▒▒▒░░░░░░░░░░░▒▒▒▓▓██▓▒▒▒░░▒▒▒▒▒░▒▒▒▒▒▒░▒▒▒▒░  ░░░░░▒▒▒▓▓▒     ▒░  ░░▒▒▒▒▒▒▒▒▒▒▒▒▒
░░░░░░▒░░░░░░░░░░░▒▒▒▒▒░░░░░░░░░░░░░░░░░░░░░░░░░░░░▒▒▒▒▒▒▒▒▒▒▒▒▒▒▒▒▒▒▒▒▒▒▒▒▒▒▒▒▓▒▓▓▓▒▒▒▓▓▒▒▒▒▒▒▒▒▒▒▓▓▒▒▓█▒▒▒▓█▓▓▒▒▒▒▓▓▒▒▒▒▒▒▒▒▒▒▒▒▒▒▒▒▒░░░▒▒░░░░░░░░░░░▒▒░░░░██▒░░░░░▒░░▒░░░░░▒▒▒░░░░░░             ░▒▒▓▓▓░    ░░░▒▒▒      ░
░░░░░░▒░░░░░▒▒▒▒▒▒▒▒▒░░░░░░░░░░░░░░░░░░░░░░░░░░░▒▒▒▒▒▒▒▒▒▒▒▒▒▒▒▒▒▒▒▒▒▒▒▒▒▒▓▓▓▒▒▓▒▓▒▓███▓▓▓▓▓▓▓▓▒▒▒▒▒▒▒▒▒▒▓▒▒▒▒▒▓▒▒▒▒▒▒▒▒▒▒▒▒▒▒▒▒▒▒▒▒▒▒░░▒▒▒░░░░░░░░░░░░░░░░░▒█▓▒▒▒░░░▒░░░░░░░░░░░░░▒▒░░               ░  ▒▒░▒▒▓▓▒▒▒▒░       
░░░░░ ▒░░░▒░░░░░░░░░░░░░░░░░░░░░░░░░░░░░░░░░░░░░░▒░▒▒▒▒▒▒▒▒▒▒▒▒▒▒▒▒▒▒▒▒▒▒▒▒▒▒▒▒▒▓▓████████▓██▓▒▒▒▒▒▒▒▒▒▒▒▒▒▒▒▒▒▒▒▒▒▒▒▒▒▒▒▒▒▒░░░░▓██▓▒▒░░▒░▒░░░░░░░▒░░ ░  ░░  ░▓▒░░░░░░▒░░░░░░░░░░░░▒▒▒░                  ░▒    ░▒ ░░░       
░░░░░ ▒░░░░░░░░░░░░░░░░░░░░░░░░░░░░░░░░░░░░░░░░▒░▒▒▒▒▒▒▒▒▒▒▒▒▒▒▒▒▒▒▒▒▒▒▒▒▒▒▒▒▒▒▒▓▓▓█▓▓▓████▓▓▓▒▓▒▒▒▒▒▒▒▒▒▒▒▒▒▒▒▒▒▒░▒▒▒▒▒▒▒░░░░░▒▒▓▓████▓▒▒▒░░░░░░▒░░░░░ ░░░   ▒▒░░░░░░░░░░░░▒▓██████████████████▓▓▒▒░     ▒     ▒   ░░░░░   
░░░░░░▒▒░░░░░░░░░░░░░░░░░░░░░░░░░░░░░░░░░░░░░▒▒▒▒▒▒▒▒▒▒▒▒▒▒▒▒▒▒▒▒▒▒▒▒▒▒▒▒▒▒▒▒▒▒▒▒▓██████▓▓▓▓▒▒▒▒▒▒▒▒▒▒▒▒▒▒▒▒▒▒▒▒▒░░░▒▒▒▒▒░░░░▒▒▒▒▓▓▓▓▓▓▓▒▓▒░░░░░░░░░░░░░░░░░ ░░▒░░░░░░░░░▒▓█████████████████████▓█▓██████▓▓▒░   ▒   ░░░░░▒▒▒
░░░░░░░░░░░░░░░░░░░░░░░░░░░░░░░░░░░░░░░░░░░░░░░░▒▒▒▒▒▒▒▒▒▒▒▒▒▒▒▒▒▒▒▒▒▒▒▒▒▒▒▒▒▒▒▒▒▒▒▒▒▒▒▒▒▒▒▒▒▒▒▒▒▒▒▒▒▒▒▒▒▒▒▒▒▒▒▒░░░░░░░▒▒▒░░▒▓▓▓▓▓▓▓▓▓▓▒▓▓░▒▒▒▒▒▒░░░░░░░░░░░░░░░▒░░░░░░░▒▓█████████████████████▓▓▓▓▓▓███████▓▓▓▓▓▒░░░░░░░░░░
░░░░  ░░░░░░░░░░░░░░░░░░░░░░░░░░░░░░░░░░░░░░░▒░▒░░▒▒▒▒▒▒▒▒▒▒▒▒▒▒▒▒▒▒▒▒▒▒▒▒▒▒▒▒▒▒▒▒▒▒▒▒▒▒▒▒▒▒▒▒▒▒▒▒▒▒▒▒▒▒▒▒▒▒▒▒▒▒▒▒▒░░░▒▒▒▒░░░▒▒▓▓▓▓▓▓██▒▒▒░▒▒▒▒▒▒▒▒░▒▒▒▒▒▒░░░░░░░░░░░░░░▒█████████████████████▓▓▓▓▓▓▓▓▓███▓█▓▓▓▓▓▓▓▓▓▓▓▒▒▒░░
░░   ░░░░░░░░░░░░░░░░░░░░░░░░░░░░░░░░░░░░░▒░░░▒▒▒▒▒▒▒▒▒▒▒▒▒▒▒▒▒▒▒▒▒▒▒▒▒▒▒▒▒▒▒▒▒▒▒▒▒▒▒▒▒▒▒▒▒▓▓▒▒▒▒▒▓▓▒▒▒▒▒▒▒▒▒▒▒▒▒▒▒▒▒▒░░░░░░░░▒▒▒▒▒▒▒▒░▒▒░▒▒▒▒▒▒▒▒▒▒▒▒▒▒▒░░░░░░░░░░░░░░░░▓████████████████▓█▓▓▓▓▓▓▓▓▓▓▓▓▓▓▓▓▓▓▓▓▓▓▓▓▓▓▓▓▓▓▓▓
░  ░░░░░░░░░░░░░░░░░░░░░░░░░░░░░░░░░░░░░░░░░░░░░▒░▒▒▒▒▒▒▒▒▒▒▒▒▒▒▒▒▒▒▒▒▒▒▒▒▒▒▒▒▒▒▒▒▒▒▒▒▒▒▒▒▒▒▒▒▒░▒▒▓▓▓▓▓▒▒▒▒▒▒▒▒▒▒▒▒▓▒░░░░░░░░▒▒▒▒▒▒▒▒▒▒▒▒▒▒▒▒▒▒▒▒▒▒▒▒▒▒▒▒▒▒▒░░░▒░░░░▒░░░░▒▓████████████▓▓▓▓▓▓▓▓▓▓▓▓▓▓▓▓▓▓▓▓▓▓▓▓▓▓▓▓▓▓▒▓▓▓▓▓▓
 ░░░░░░░░░░░░░░░░░░░░░░░░░░░░░░░░░░░░░▒░░░░░░▒▒▒▒▒▒▒▒▒▒▒▒▒▒▒▒▒▒▒▒▒▒▒▒▒▒▒▒▒▒▒▒▒▒░▒▒▒▒▒▒▒▒▒▒▒▒▒▒░▒▒▒▒▒▓▓▓▓▓▒▓▓▓▒▒▓▓▓▓▒░░▒░░░░░▒▒▒▒▒▒▒▒▒▒▒▒▒▒░▒▒▒▒▒▒▒▒▒▒▒▒▒▒▒▒▒▒▒▒▒▒▒░▒▒░░░░░▒▓████████████▓▓█▓▓▓▓▓▓▓▓▓▓▓▓▓▓▓▓▓▓▓▓▓▓▓▓▓▓▓▒▓▓▒▒▓
 ░░░░░░░░░░░░░░░░░░░░░░░░░░░░░░░░░░░░░░░░▒▒▒▒▒▒░▒▒▒▒▒▒▒▒▒▒▒▒▒▒▒▒▒▒▒▒▒▒▒▒▒▒▒▒▒▒▒▒▓▒▒▒▒▒▒▒▒▒▒▒▒▒░▒▒▒░░▒▓██▓▓▓▓▓▒▓█▒░░▒░░░░▒▒░░▒▒▒▒▒▒▒▒▒▒▒▒▒▒▒░▒▒▒▒▒▒▒▒▒▒▒▒▒▒▒▒▒▒▒▒▒▒░░▒░▒▒░░▒░▒███████████▓▓▓▓▓▓▓▓▓▓▓▓▓▓▓▓▓▓▓▓▓▓▓▓▓▓▓▓▓▓▓▓▓▒▒▒