▓▓▓▓▓▒▒▒▒▒▒▒▒▓███████▒▒▒▒▓██████▒▒▒▒▒▒▓██████████████████▓███████████████████████▓▓▓███████▓▓▓▓▓▓▓▓▓▒▒▒▒▒▒▒▓▓▓▓▒▒▒▒▒▓▓▓▓▓▓▓▓████████▓▓▓████▓▓▓▓▓▒▓▓▓▓▓▓▓▓▓▓▓▓▓▓▓███████████▓▓▓▓▓▓▓▓▓▒▒▒▒███▓█████▒███▒▒▒▒▒▒▒▒▒▓████████████▓
▓▓▓▓▓▓▓▒▒▒▒▒▒▓███████▒▒▒▒▒▒█████▓▒▒▒▒▒▒▓█████████████████▓▓▓▓█████████████████████▓██████████▓▓▓▓▓▓▓▒▒▒▒▒▒▒▒▒▒▓▒▒▒▓▒▒▒▓▓▓▓▓▓▓▓█████▓▓▓▒▒▒▒▓▓▒▒▒▒▓▓▓██████████▓▓▓████▓▒█████▓▓▓▓▓▓▓▓▓▒▒▒▒▓▒░▒███▒░░▒▒▒▒▒▒▒▒▒▒▒▓██████████████
▓▓▓▓▓▓▓▓▒▒▒▒▒▒▓███████▒▒▒▒▒▓█████▓▒▒▒▒▒▓██████████████████████████████████████████▓██████████▓▓▓▓▓▓▓▒▒▒▒▒▒▒▒▒▒▓▒▒▒▒▓▓▒▒▓▓▓▒▒▒▓▓▓▓▓▒▓▓▓▒▒▓▒█▓▓▒▒▒▓▓▓██████████▓▓█▓▒▒▒▒▒▒▒▓█▓▓▓▓▓▓▓▓▓▒▒▒▒▒░▒██████░░▒▒▒▒▒▒▒▒▒▒▓▓██▓███████▓▓▓█
▓▓▓▓▓▓▓▓▒▒▒▒▒▒▒▓██████▓▒▒▒▒▒██████▒▒▒▒▒▒▓█████████████████████████████████████████▓████████████▓▓▓▓▓▒▒▒▒████▓█▓▒▒▒▓▒▒▒▒▒▓▓▓▒░▓██▓▒▒▓▓▓▒▒▓▓█▓█▒▒▒▓▓▓███▓█▓▒▓█▓▓▓█▒▒▒▒▒▒▒███▓▓▓▓▒▓▓▓▓▒▒▒▒▒▒▒▓██▓▒▒▒▒▒▒▒▒▒▒▒▒▒▓▓█▓██▓█▓████▓█▓█
▓▓▓▓▓▓▓▓▓▓▒▒▒▒▒▓▓███████▒░░░██████▓▒▒▒▒▒▒█████████████████████████████████████████▓█████████████▓▓▓▓▓▒▒▒██████▒▒▒▒▒▒█████▓▒▒░▒▒▒▒░▒▓▓▒▒▒▒██▒▒▒▒▓▓▓█████▒▒▒▒█▓▒███▓▒▓▒▓███▓▓▓▓▓▓▓▓▓▒▒▒▒▒▒▓▓▓▓▓▓▒▒▒▒▒░▒▒▒▒▒▒▓██████████▓████▓▓
▓▓▓▓▓▓▓▓▓▓▓▒▒▒▒▒▓████████▓▓▓███████▓▒▒▒▒▒▓█████████▓▓▓▓▓▓▓▓█▓▓▓▓▓▓▓██████▓▓▓▓▓█████▓████████████▓▓▓▓▒▒▒▒██████▒▒▒▒▒▒█████▓▓▒▒░░▒▒▒▓▓▓▒▒▒▒▓▓▒▒▒▒▓▓▓█████▓▒▓██▓▒███████████▓▓▒▓▓▓▓▓▒▒▒▒▒▓▓▓▓▓▒▓▓▓▓▒░░▒▒▒▒▒▒▒▓███████████▓▓▓▓▓█
▓▓▓▓▓▓▓▓▓▓▓▓▓▓▓▒▒▒▒▒▒▒▒▒▒▒▒▒▒▒▒▒▓▓▓▓▒▒▒▒▒▒▒▒▓▒▓▓▓▓▓▓▓▓▓▓▓▓▓▓▓▒▒▒▒▒▓▒▓▒▓▒▒▒▒▒▒▒▒▒▒▒▒▓█████████████▓▓▓▓▒▒▒▓▓▓█▓█▒▒▒▒▒▒██▓██▓▓▒▒▒▒▒▒▒▒▓▓▒▒▒▒▓▓▒▒▒▒▓▓▓█████████▓▓▓██████████▓▓▒▓▓▓▓▒▒▒▒▒▒▒▓▒▓▓▓▓▓▒▒▒▒░░▒▒▒▒▒▒▓█████▓██▓▓▓▓▓▓▓███
██████████████▓▓▓▒▒▒▒▒▒▒▒▒▒▒▒▒▒▒▓██▓▓▓▒▒▒▒▒▒▒▒▒▒▒▒▒▒▒▒▒▒▒▒▒▒▒▒▒▒▒▒▒▒▒▒▒▒▒▒▒▒▒▒░░▒▒▒▓█████████████▓▓▓▓▒▒▒▒▒▒▒▒▒▒▒▒▒▒▒█████▓▒▓▒▒▓▓▓▒▓▒▒▒▒▒▒▒▓▒▒▒▓▓▓██████████▓▒▒▒▒▒▒▒▒▒▓███▓▓▓▓▓▓▓▒▒▒▒▒▒▒▒▒▒▒▒▒▒▒▒▒▒▒▒▒▒▒▒▓████████▓██▓▓█▓▓██▓
████████████████▓▓▒▒▒▒▒▓▓▓▓▓▓▓▓▓▓██▓▓▓▒▒▒▒▒▒▒▒▒▒▒▒▒▒▒▒▓▒▓▒▒▒▒▒▒▒▒▒▒▒▒▒▒▒▒▒▒▒▒▒▒▒▒▒▒▓▓█████████████▓▓▓▒▒▒▒▒▒▒▒▒▒▒▒▒▒▒▓▓▓▓▓▒▒▒▓▒▒▓▒▓▒▓▒▒▒▒▒▒▒▒▒▒▓▓▓█████████▓▓▓▓▓▓▓▒▓█▓▓████▓▓▓▓▒▒▒▒▒▒▒▒▒▒▒▒▒▒▒▒▒▒▒▒▒▒▒▒▒▓██████████▓█▓█▓▓████
██████████████████▓▒▓▓▒▓▓██▓████████▓▓▒▒▒▓▓▓▓▓▓▓▓▓▓▓▓▓▓▓▓▓▓▓▓▓▒▒▒▒▒▒▒▓▓▓▓▓▓▒▒▒▒▒▒▒▒▓▓▓█████████████▓▓▒▒▒▒▒▒▒▒▒▒▒▒▒▒▒▒▒▒▒▒▒▒▒▓▒▓▒▓▒▓▒▓▒▓▓▓▓▓▓▓▓▓▒▓▓▓▓▓▓▓▓▒▓▓▒▒▒▒▒▒▒▓█████████▒▒▒▒▒▒▒▒▒▓▓▓███████▓▓▓▓▒▒▒▓███████▓█▓▓█▓█▓▓▓▓▓▓▓
███████████████████▓▒▓▓▒█████████████▓▒▒▒▒▒▓▓▓▓▓▓▓▓▓▓▓▓▓▓▓▓▓▓▓▒▒▒▒▒▒▒▒▒▒░░░░░░░▒▒▒▒▒▓█▓▓███████████▓▓▒▒▒▒▒▒▒▒▒▒▒▒▒▒▒▒▒▒▒▒▒▒▒▒▒▒▓▒▒▒▓▓▓▓▒▓▓▒▓▓▓▒▓▓▓▓▓▓▒▓▓▒▒▒▓▒▒▒▒▒▓█████████▒▒▒▒▒▒▒▒▒▒▓▓▓▓▓███▓▓▓▓▓▒▒▒▓███████▓██▓▓▓█▓▓▓▓▓▓▓▓
███████████████████▒▒▒▒▒▒▓███████████▓▓▓▓▒▒▒▓▓▓▓▓█▓███████████▓▒▒▒▒▒▒▒▒░░░░░░░░▒▒▒░▒░▒▒░░▓████████▓█▓▒▒▒▒▒▒▒▒▒▒▒▒▒▒▒▒▒▒▒▒▒▒▒▒▒▒▒▓▓▒▒▓▓▒▓▓▓▓▓▓▓▓▓▒▓▒▓▓▒▒▓▒▓▒▓▒▒▒▒▒█████████▒▒▒▒▒▒▒▒▒▒▓▓▒░░▒▓██▓▒▓▓▒▒▒▒▓█████████▓█▓█▓▓█▓▓▓▓▓▓
█████████████████████▓▒▒▒▒▓███████████▓▓▓▒▒▒▓▓███████████████▓▓▓▒▒▒▒▒▒▒░░░░░░░░▒▒▒░▒░░░░░▒▓▓███████▓▓▒▒▒▒▒▒▒▒▒▒▒▒▒▒▒▒▒▒▒▒▒▒▒▒▓▒▒▒▒▒▒▒▒▓▓▒▓▒▒▓▓▒▓▒▒▓▒▓▒▓▒▒▒▒▒▒▒▒▒█████████▒▒▒▒▒▒▒▒▒▒▓▓▒░░▒▓▓▓▓▒▓▓▒▒▒▒▓████▓██▓▓▓▓▓▓▓▓█▓███▓▓▓
██████████████████████████████████████▓▓▓▓▒▒▓▒▓█▓▓▒▒▓███▓▓▓▓▒▒▒▒▒▒▓▒▒▒▒▒▒░▒▒▒▒▒▒▒▒░░░░░░░░▓▓▓▓███▓█▓▓▒▒▒▒▒▒▒▒▒▒▒▒▒▒▒▒▒▒▒▒▒▒▒▒▒▒▒▒▒▒▒▒▒▒▒▓▒▓▒▒▒▒▒▓▓▓▒▒▒▒▓▒▒▒▒▒▒▒████████▓▒▒▒▒▒▒▒▒▒▒▒▓▒▒▒▒▒▒▒▓▓▓▓▒▒▒▒▓█▓▓▓███▓▓█▓▓▓▓▓▓▓▓▓▓▓▓▓▓
█████████████████████████████▓▓█████▓▓▓▓▓▓▒░▒▒▒▓▓██████▓▒▓▓▒▒▒▓▓▓▓▓▒▒▒▒▒▒▒▒▒░░░▒▒▒░▒▒▒▒▒▒▒▒▒▓▓▓▓▓█▓▓▓▓▓▓▓▒▒▒▒▒▒▒▒▒▒▒▒▒▒▒▒▒▒▒▒▒▒▒▒▒▒▒▒▒▒▒▒▒▒▓▒▒▒▒▒▒▒▒▓▒▒▒▒▒▒▒▒▒▓▓▓▓▓▓▓█▓▒▒▒▒▒▒▒▒▒▒▒▓▓▓▓▓▒▓▓▓▓▓▓▒▒▒▒▓███▓▓▓█▓█▓▓▓▓▓▓▓█▓▓█▓▓▓▓▓
█████████████████████▓▒█████▓██▒░░▒▓▒▒▒▓▒▒░░░░▒▒▒▓███▓▓█▓▒▓▓▒▒▒▓▒▒▒▒▒▓▓▒▒▒▒▒▒▒▒▒▒▒▒▒▒▒▓▓▓██▓▓██▓▓▓▓▓▓▓▓▒▒▒▒▓▓▓▓▓▓▓▓▓▓▓▓▓▓▓▒▒▒▒▒▒▒▒▒▒▒▒▒▒▒▒▒▒▒▒▒▒▒▒▓▒▒▒▒▒▒▒▒▒▒▒▒▒▒▒▒▒▒▓▒▒▒▒▒▒▒▒▒▒▒▓▓▓▓▓▓▓▓▓▓▓▓▒▒▒▒▓▓▓▓▓▓█▓▓▓▓▓▓▓▓▓▓▓▓▓▓▓▓▓▓▓▓
█████████████████████▒▒▓██▓████▓░░░▒▒▒▓▓▓▒▒▒▒▒▒▒▒▒▓██▒▒▓▓▓▓▓▓▓▓▓▓▒▒▒▒▒▒░░░░░░░▒▒▓▓▓▓▓▓▓▓██▓▒▒▓▓▓▓▓▓▓▓▓▓▓▒▓▒▒▓▓▓▓▓▓▓▓▓▓▓█▓▓▓██▓█▓▓▓▓▓▓▓▓▓▓▓▒▒▒▒▒▒▒▒▒▒▒▒▒▒▒▒▒▒▒▒▒▒▒▒▒▒▒▒▒▒▒▒▒▒▒▒▒▒▒▓▒▓▓▓▓▓▓███▒▒▒▒▓▓█▓▓▓▓▓▓▓▓▓▓▓▓▓▓▓▓▓▓▓▓▓▓▓▓▓
█████████████████▒▒▓██▓▒▓▓██████▓▒▒▒▓▒▒▒▒▒▒▒▒▒▒░▒▒▒▓▓▓▓▒▒▒▒▒▒▒▒▒░░░░░▒▒▒▓▓██████▓▓▓███████▓▒▒▒▒▒▒▒▒▒▒▓▒▓▒▒▓▓▓▒▒▓▓▓▓▓▓▓▓▓█▓▓▓██▓█████████████▓▓████████▓▓▓▓▓▒▒▒▒▒▒▒▒▒▒▒░▒▒▒▒▒▒▒▒▒▒▒▒▒▒▒▒▒▒▒▒▒▒▒▒▓▓▓▓▓▓▓▓▓▓▓▓▓▓▓▓▓▓▓▓▓▓▓▓▓▓▓▓▓
▒▒▓████▒▓▓▒▓█████▒▒▒▓▓█▓▓▓▓▓▓▓▓▓▓▓▓▓▓▓▓▓▓▓▓▓▓▒▒▒▒▒▒▒▒▒▒▒▒▓▓▓▓██▓▒▒▓███████████▓▒▓████▓▓▓▓▓▓▓▒▒▒▒▒▒▒▒▒▓▒▒▒▒▒▓▒▒▒▒▒▒▒▒▒▓▒▓▓▓▓▓▓▓█▓▓▓███████▓▓▓▓▓▓▒▒▒▒▓▓▓▓███████████▓█▓▓▓▓▓▓▓▒▒▒▒▒▒▒▒░░░░░▒▒▒▒▒▒▒▓▓▓▓▓▓▓▓▓▓▓▓▓▓▓▓▓▓▓▓▓▓▓▓▓▓▓▓▓
░░░░░░▒▓▒▒▒▒▒▒▒▒█▓▒▒▒▓▓▓▒▒▒▒▓▓▓██████▓▓▒▒▒▒▒▒▒▒▓▓▓█████████████▓▒▒▓████████████▓▓▓▓███▓▓▓▓▓▓▒▒▒▒▒▒▒▒▒▓▒▒▒▒▒▓▒▒▒▒▒▒▒▒▒▒▒▒▒▒▒▒▒▒▒▓▓▓▒▓▓▓▓▓▓█▓▓▓▓▓▓▓▓▒▓▓▓▓▓██████████████████████████▓▓▓▓▓▓▓▓▒▒▒▓▓▓▓▓▓▓▓▓▓▓▓▓▓▓▓▓▓▓▓▓▓▓▓▓▓▓▓▓▓▓
░░░░░░░░▒▒░░░▒▒▒▓██▓▒▓▓▓██▓▓▓▓▓▒▒▒▒▒▒▒▒▓▓▓██▓██████████▓████████▓▒▓██████████████▓▓▓▓▓▓▓▓▓▓▓▒▒▒▒▒▒▒▒▒▒▒▒▒▒▒▒▓▒▒▒▒▒▒▒▒▒▒▒▒▒▒▒▒▒▒▒▒▒▒▒▒▒▒▒▒▓▓▓▓▓▓▓▓▓▓▓▓▓▓▓█▓███████████████████▓▓▓▓▓▒▓███████▓▓▓▓▓▓▓▓▓▓▓▓▓▓▓▓▓▓▓▓▓▓▓▓▓▓▓▓▓▓▓▓▓
░░░░░░░░░░▒▓▓▓██▓▓▒▒▒▒▒▒▒▒▒▒▒▒▓▓▓███████████▓▓█▓▒███████████████▓▒▒▓█████████████▓▓█▓▓▓▓▓▓▓▓▒▒▒▒▒▒▒▒▒▒▒▒▒▒▒▒▒▒▒▒▒▒▒▒▒▒▓▒▒▒▒▒▒▒▒▒▒▒▒▒▒▒▒▒▒▓▒▒▒▒▒▒▒▓▓▓▒▓▓█▒▓▓▓▓▓▓████████▓▓▓█▓▓▓▓▓▓▓▓▓▓▓▓█▓▓▓▓██▓▓▓▓▓▓▓▓▓▓▓▓▓▓▓▓▓▓▓▓▓▓▓▓▓▓▓▓▓▓
██████▓▓▓▒▒▓▒▒▒▒▒▒▒▒▒▓▓▓▓█████████▓▒▒▒▓▓██████▓█▓█████████████▓▓▓▓▒▓██████████████▓▓▓▓▓▓▓▓▓▓▒▒▒▒▒▒▒▒▒▒▒▒▒▒▒▒▒▒▒▒▒▒▒▒▒▒▒▒▒▒▒▒▒▒███▓▒▒▒▒▒▒▒▓▒▒▒▒▒▒▒▒▒▒▒▒▓▒▒▒▒▒▓▓▓▓▓▓▓▓▓▓▓▓▓▓█▓▓▓▓▓▓▓▓▓▓▓▓▓█▓▓▓▓▓██▓▓▓▓▓▓▓▓▓▓▓▓▓▓▓▓▓▓▓▒▒▒▓▓▓▓▓▓
▓▓▓▒▒▒▒▒▒▒▒▒▒▓▓▓▓▓▓▓▓██████████████▓▓▓▓▒▓████████▓███████▓█▓█▓████▓▓███▓▓▓███████▓▓▓▓▓▓▓▓▓▓▓▒▒▒▒▓▓▓▓▓▓▓▓▓▓▒▒▒▒▒▒▒▒▒▒▒▒▒▒▒▒▒▒▒▒▓▓█▓▒▒▒▒▒▒▒▒▒▒▒▒▒▒▒▒▒▒▒▓█▓▒▒▒▒▒▒▒▒▒▒▒▒▒▒▒▒▒▓▓▒▓▓▓▒▓▓▓▒▓▓▓▓█▓▓▓▓▓██▓▓▓▓▓▓▓▓▓▓▓▓▓▓▓▓▓▓▓▓▓▓▓▓▓▓▓▓
▒▒▒▓▓▓▓▓▓▓▓▓▓▓▓████▓▓█▓▓▓▓▓▓▓█▓██████▓▓▓▒▓█▓█▓█▓▓▓▓██████████████▓▒▒▓███████▓▓████▓▓▓▓▓▓▓▓▓▓▒▒▒▒▒▒▓▓▓▓▓▓▒▒▒▒▒▒▒▒▒▒▒▒▒▒▒▒▒▒▒▒▒▒▒▒▒▒▒▒▒▒▒▒▒▒▒▒▒▒▒▒▓▒▒▒▒▒▒▒▓█▓▒▒▒▒▒▒▒▒▒▒▒▒▒▒▓▒▒▒▓▒▒▒▒▒▒▒▒▒▓▓▓▓▓▓▓▓▓▓▓▓▓▓▓▓▓▓▓▓▓▓▓▓▓▓▓▓▓▓▓▓▓▓▓▓▓
███▓▓▓▓▒▒▓▓█▓█▓▓▓▓▓▓▓▓▓██████████████▓▓▓▒▒▓▓▓█▓▓▓▓▓▓█████████▓█▓██▓▒▓█████████▓███▓▓█▓▓▓▓▓▒▒░░▒▒▒▒▒▒▒▒▒▒▒▒▓▓▓▓▒▓▒▒▒▒▒▒▒▒▒▒▒▒▒▒▒▒▒▒▒▒▒▒▒▒▒▒▒▒▒▒▒▓▓▒▒▒▒▒▒▒▒▓▒▓█▓▒▒▒▒▒▒▒▒▒▒▓▓▒▒▒▓▒▒▒▒▒▒▒▒▒▒▒▒▒▒▓▒▒▒▒▒▒▒▓▓▓▓▓▓▓▓▓▓▓▓▓▓▓▓▓▓▓▓▓▓▓▓
▒▒▒▒▓▓▓▓▓▓▓▓▓▓▓▓▓████▓▓▓█████████▓█▓▓▓▓▓▓▒▓█▓▓███▓▓▓█████████▓█▓███▒▓▓█████████▓███▓▓▒▒░░░░░░░▒▒▒▓▓▓▓▓▓▓▓▓▓▓▓▓▓▓▓▓▓▒▒▒▒▒▒▒▒▒▒▒▒▒▒▒▒▒▒▒▒▒▒░▒▒▒▒▒▓▒▒▒▒▒▒▒▒▒▓▓▒██▒▒▒▒▒▒▒▒▒▒▓▒▒▒▓▒▒▒▒▒▒▒▒▓▒▒▒▒▓▒▒▒▒▒▒▒▒▒▒▒▒▒▒▒▒▒▒▒▒▒▓▓▓▓▓▓▒▒▒▒▓▓
▓▓▓▓▓▓▓▓▓▓▓██▓▓▓▓▓▓▓█▓▓▓▓▓▓▓▓▓▓▓▓▓▓█▓▓▓▓█▒▒██▓▓▓▓▓▓▓▓█████████▓███▓▓▓▒█████████████▒▓░░░▒▓▓▓▓█▓█████████▓██████████████▓▓▒▒▒▒▒▒▒▒▒▒▒▒▒▒▒▒▒▒▒▒▒▓▒▒▒▓▒▒▒▒▒▒▓▓▒██▒▒▒▒▒▒▒▒▒▒▒▒▒▓▒▒▒▒▒▒▒▒▓▒▒▒▓▒▒▒▒▒▒▒▒▒▒▒▒▒▒▒▒▒▒▒▓██▓▒▒▒▒▒▒▒▒▓▓▓█
▓▓▓████▓▓▓▓▓▒▓▓▓▓▓▓▓▓▓▓▓▓▓▓▓▓▓▓▓▓▓████▓▓▓█▒▓██▓▓█▓▓▓▒▒████████▓▒█▓██▒▓▓████████████▒▓████▓▓████▓▓▓██████████▓████████████████▓▒▒▒▒▒▒▒▒▒▒▒▒▒▒▒▓▓▒▒▓▒▒▒▒▒▒▒▓▒▒█▓▒▒▒▒▒▒▒▒▒▓▒▒▒▓▒▒▒▒▒▒▓▒▒▒▒▓▒▒▒▒▒▒▒▒▒▒▒▒▒▒▒▒▒▒▓█▓▒▒▒▒▒▒▒▒▒▓██▓▒▒
▓▓▓▓▓▒▒▒▓▓▒▒▒▓▓▓▓▓▓▓▓▓▓▓▓▓▓▓██▓█▓██▓█▓█▓▒▓▒▒▓▒▒▓▓▓▓▓▓▒▓███▓▓▓▓▓▓▓▓▓█▓▒▓████████▒▓████████████▓█▓▓▓███▓█▓▓▓██████████████████████▓▒▒▒▒░░░▒▓▒▒▒▓▒▒▓▒▒▒▒▒▒▒▓▒▒▓▒▒▒▒▒▒▒▒▒▒▒▒▒▒▒▒▒▒▒▒▒▒▒▒▒▓▒▒▒▒▒▒▒▒▒▒▒▒▒▒▒▒▒▒▒▓▓▒▒▒▒▒▒▒▒█▓▒▒▒▒▒▒▒
▒▒▒▒▒▒▓▓▓▓▓▓▓▓▓▓▓▓▓█▓▓▓█▓▓▓▓▓▓▓▓▓▓▓▓█▓▓▓▓▓▒▒▒▓▓▓███▓▓▓▒▒▒▒▓▓▓███▓▓▓▓▓▒▒▓███▓░▒▓██████████▓████▓▓▓▓▓▓███▓███████████████████████████▒▒▒▒░░░░░▒▒░▒▒▒▒▒▒▒▒▒▒▒▒▒▒▒▒▒▒▒▒▒▒▒▒▒▒▒▒▒▒▒▒▒▒▒▒▒▓▒▒▒▒▒▒▒▒▒▒▒▒▒▒▒▒▒▒▒▒▓▓▒▒▒▒▒▒▓▓▒▒▒▒▒▒▒▒▒
▓▓▓▓▓▓▓▓▓▓▓▓▓▓▓▓▓▓▓▓▓▓▓▓▓▓▓▓▓▓▓▓▓▓▓▓▓▓▓▓██▓▓▓▓▓▓▓▓▓▓▓▓▓▓▓▓▓█▓▓▓▓▓▒▒▓▒░░░▒▒▒▒▓█████████████████▓▓▓▓▓▓▓████████████████████████████████▒░░░░░▒▒▒▒▒░▒▒▒▒▒▒▒▒▒▒▒▒▒▒▓▓▓▓▓▓▓▓▓▓▓▓▒▒▒▒▒▒▒▒▒▒▒▒▒▒▒▒▒▒▒▒▒▒▒▒▒▒▒▒▒▒▓▒▒▒▒▒▒▒▓▒▒▒▒▒▒▒▒▒▒
▓▓▓▓▓▓▓▓▓▓▓▓▒▒▒▒▓▓▓▓▓▓▓▓▓▓▓▓▓▓▓▓▓▓▓██▓██▓▓▓▓▓▓▓▓▓▓▓▓▓▓▓█▓▓▓▓▒▒░░░░░░▒▒░▒▒▒▓█████████████████████▓▓▓▓▓█████████████████████████████████▒░░░░▒▒▒▒▒▒▒▒▒▒▒▒▒▒▒▒▒▒░░▒▒▓▓▓▓▓▓▓▓▓▓▓▓▓▒▒▒▒▒▒▒▒▒▒▒▒▒▒▒▒▒▒▒▒▒▒▒▒▒▒▒▓▒▒▒▒▒▒▓▒▒▒▒▒▒▒▒▒▒▒
▓▓▓▒▒▓▒▒▒▓▓▓▓▓▓▓▓▓▓▓▓▓▓▓▓▓▓█▓▓▓██▓▓▓▓▓▓▓▓▓▓▓▓▓▓▓▓▓▓▓▓▓▓▓▒▒░░░░░░░░░░▒▒▒▒▒▓▓██████████████████████▓▓▓▓█████████████████████████████████▓░░░░▒▒▒▒▒░▒▒▒▒▒▒▒▒▒▒▒▒▒░░░░▒▒▓▓▓▓▓▒▒▒▒▒▓▓▓▒▒▒▒▒▒▒▒░▒▒▒▒▒▒▒▒▒▒▒▒▒▒▒▓▒▒▒▒▒▒▒▒▒▒▒▒▒▒▒▒▒▒
▓▓▓▒▒▓▓▓▓▓▓▓▓▓▓▓▓▓▓▓▓▓▓▓▓▓▓▓▓▓▓▓▓▓▓▓▓▓▓▓▓▓▓▓▓▓▓▓▓▓▓▓▒▒░░░░░░░░░░▒▒▒▒▒▒▒▒▒▓█████████████████████████▓▓██████████████████████████████████▓▒░▒▒▒▒▒░░▒▒▒▒▒▒▒▒▒▒▒▒▒▒▒░░░░░░░▒▒▒▒▒▒▓▓▒▒▒▒▒▒▒▒▒░▒▒▒▒▒▒▒▒▒▒▒▒▒▒▒▓▓▒▒▒▒▒▓▒▒▒▒▒▒▒▒▒▒▒▒
▓▓▓▓▓▓▓▓▓▓▓▓▓▓▓▓▓▓▓▓▓▓▓▓▓▓▓▓▓▓▓▓▓▓▓▓▓▓▓▓▓▓▓▓▓▓▓▓▒▒░░░░░░░░░░░▒▒▒▒▒▒▒▒▒▒▒▒▓███████████████████████████████████████████████████████████████▓▓▓▒▓▒▒░▒▒▒▒▒▒▒▒▒▒▒▒▒▒░▒░░░▒▒▒▒░░▒░░░░▒▒▒▒▒▒▒▒░▒▒▒▒▒▒▒▒▒▒▒▒▒▒▒▒▓▒▒▒▒▒▒▒▒▒▒▒▒▒▒▒▒▒░▒
▓▓▓▓▓▓▓▓▓▓▓▓▓▓▓▒▓▒▒▓▓▓▓▓▓▓▓▓▓▓▓▓▓▓▓▓▓▓▓▓▓▓▓▒▒░░░░░░░░░░░░░▒▒▒▒▒▒▒▒▒▒▒▒▒▒▒▓█████████████████████████████████████████████████████████████▓▓███▓▓▒▒▒▒▒▒▒▒▒▒░▒▒▒░░░░░░░░░▒▒▒▒▒▒▒▒▒▒▒▒▒▒▒▒▒░░▒▒▒▒▒▒▒▒▒▒▒▒▒▒▒▒▓▒▒▒▒▒▓▒▒▒▒▒▒▒▒▒▒▒▒▒
▓▓▓▓▓▓▓▓▓▓▒▒▒▒▒▓▓▓▓▓▓▓▓▓▓▓▓▓▓▓▓▓▓▓▓▓▓▓▓▒░░░▒░░░░░░░░░▒▒▒▒▒▒▒▒▒▒▒▒▒▒▒▒▒▒▒▒▒▒██████████████████████████████████████████████████████████▓▓▓▓▓▓▓▓▓▓▒▒▒▒▒▒▒▒▒▒▒░░░░░░░░░░░░░▒▒▒▒▒▒▒▒▒▒▒▒▒▒▒▒▒▒▒▒▒▒▒▒▒▒▒▒▒▒▒▒▓▒▒▒▒▒▒▒▒▒░░▒▒▒░░░░▒▓
▓▓▓▓▓▓▓▓▒▒▓▓▓▓▓▓▓▓▓▓▓▓▓▓▓▓▓▓▓▓▓▓▓▓▓▒░░░▒░░░░░░░░░▒▒▒▒▒▒▒▒▒▒▒▒▒▒▒▒▒▒▒▒▒▒▒▒▒▒▒▓██████████████████████████████████████████████████████▓▓▓▓▓▓▓▓▓▓▓▓▓▒▒▒▒▒▒▒▒▒░░░░░░░░░░░░░░▒▒░░░▒░░▒▒▒▒▒▒▒▒▒▒▒▒▒▒▒▒▒▒▒▒▒▒▒▒▒▒▒▒▒▒▒▒░░▒▒▒▒░░░░▒▓▒
▓▓▓▓▓▓▓▓▓▓▓▓▓▓▓▓▓▓▓▓▓▓▒▒▓▓▓▓▓▓▓▒░░░▒░░░░░░░░░▒▒▒▒▒▒▒▒▒▒▒▒▒▒▒▒▒▒▒▒▒▒▒▒▒▒▒▒▒▒▒▒▒▓██████████████████████████████████████████████████▓▒▓██████████▓▒▒▒▒▒▒▒░░░░░░░░░░░░░░░░▒▒░░░░░▒▒▒▒▒▒▒▒▒▒▒▒▒▒▒▒▒▒▒▒▒▒▒▒▒▒▒░▒▒▒▒░░░▒░▒░░░░▒▓▒▒░
▓▓▓▓▓▓▓▓▓▓▓▓▓▓▓▓▓▒▒▒▓▓▓▓▓▓▒▒░░░░░░░░░░░░░▒▒▒▒▒▓▓▒▒▒▒▒▒▒▒▒▒▒▒▒▒▒▒▒▒▒▒▒▒▒▒▒▒▒▒▒▒▒░▒▓▓███████████████████████████████████████████▓▒▒▒░░▒▒▒▓▓▓▓▒▒▒▒▒▒▒▒▒▒▒▒▒▒▒▒▒▒▒▒▒░░░░░▒▓░░░░░░░▒▒▒▒▒▒▒▒▒▒▒▒▒▒▒▒▒▒▒▒▒▒▒▒▒▒▒▒▒▒▒▒░░▒░░░░░▒▒▒░░░
▓▓▓▓▓▓▓▓▓▓▓▓▓▒▒▓▓▓▓▓▓▓▒▒░░░░░░░░░░░░░▒▒▒▒▒▒▒▒▒▓███▓▒▒▒▒▒▒▒▒▒▒▒▒▒▒▒▒▒▒▒▒▒▒▒▒░░░░░░░░░▒▓▓█████████████████████████████████▓▓▓▒▒▒▒░▒▒▒▒▒▒▒▒▒▒▒▓▒▓▒▒▒▒▒▒▒▒▒▒▒▒▒▒▒▒▒▒▒▒░░▒▓▒▒░░▒▒▒▒▒▒▒▒▒▒▒▒▒▒▒▒▒▒▒▒▒▒▒▒▒▒▒▒▒▒▒▒▒▒▒▒▒▒▒▒▒▒▒▒▒░░░░░
░▒▓▓▓▓▓▓▓▓▓▓▓▓▓▓▓▒▒░░░░░░░░░░░░░░░▒▒▒▒▒▒▒▒▒▒▒▒▒▒▒████▓▒▒▒▒▒▒▒▒▒▒▒▒▒▒▒▒▒▒▒▒░▒▒▒▒▒▒░░▒▒░▒▒▒▒▒▒▓▓▓█████████████████▓▓▓▓▓▒▒▒▒▒▒░░░░▒▒░░░░░▒▒▒▒▒▒▒▒▒▒▒▒▒▒▒▒▒▒▒▒▒▒▒▒▒▒▒▒▒░▒▒▒▒▒▒▒▒▒▒▒▒▒▒▒▒▒▒▒▒▒▒▒▒▒▒▒▒▒▒▒▓▓▓▓▓▓▓▓▓▒▒▒▒▒▒▒▒▒▒▒▒▒▒░░
 ░▒▓▓▓▓▓▓▓▓▓▓▒▒░░░░░░░░░░░░░░░▒▒▒▒▒▒▒▒▒▒▒▒▒▒▒▒▒▒▒▒▒▓████▓▒▒▒▒▒▒▒▒▒▒▒▒▒▒▒▒▒░▒▒▒▒▒▒▒░▒▒▒▒▒▒▒▒▒▒▒▒▒▒▒▒▒▒▒▒▒▒▒▒▒▒▒▒▒▒▒▒▒▒░░░░░░░░░▒▒░░░░░░░░░▒▒▒▒▒▒▒▒▒▒▒▒▒▒▒▒▒▒▒▒▒▒▒▒▒▒░▒▒▒▒▒▒▒▒▒▒▒▒▒▒▒▒▒▒▒▒▒▒▒▒▒▒▒▒▒▒▒▓▓▓▓▓▓▓▓▓▓▓▓▓▓▓▒▒▒▒▒▒▒▒▒▒
   ░▒▓▓▓▓▒░░░░░░░░░░░░░░░░▒▒▒▒▒▒▒▒▒▒▒▒▒▒▒▒▒▒▒▒▒▒▒▒▒▒▒▒▓█████▓▒▒▒▒▒▒▒▒▒▒▒▒▒░▒▒▒▒░▒░░▒▒▒▒▒░▒▒▒░░░░░░▒▒░░░░░░▒░░░▒░░░░░░░░░░░░░░░▒░░░░░░░░░░▒▒▒▒▒▒▒▒▒▒▒▒▒▒▒▒▒▒▒▒▒▒▒▒▒▒▒▒▒▒▒▒▒▒▒▒▒▒▒▒▒▒▒▒▒▒▒▒▒▒▒▒▒▒▒▒░▒▓▓▓▓▓▓▓▓▓▓▓▓▓▓▓▓▓▓▓▓▒▒▒▒░
░░░ ░░░░ ░ ░░░░░░░░░░░░▒▒▒▒▒▒▒▒▒▒▒▒▒▒▒▒▒▒▒▒▒▒▒▒▒▒▒▒▒▒▒▒▒▒▒▓█████▓▒▒▒▒▒▒▒▒▒░░▒░░▒▒▒░░▒░░░░░░░░░░░░░░░▒▒░░░▒▒░░░░░░░░░░░▒▒▒▒░░░▒▒░░░░░░░░░░▒▒▒▒▒▒▒▒▒▒▒▒▒▒▒▒▒▒▒▒▒▒▒▒▒▒▒▒▒▒▒▒▒▒▒▒▒▒▒▒▒▒▒▒▒▒▒▒▒▒▒▒▒░▒▒▒░░▒▓▓▓▓▓▓▓▓▓▓▓▓▓▒▒▒▒▒▒▒▒▒▒
░ ░░░░░░░░░░░░░░░░░▒▒▒▒▒▒▒▒▒▒▒▒▒▒▒▒▒▒▒▒▒▒▒▒▒▒▒▒▒▒▒▒▒▒▒▒▒▓▓▒▒▒▒▓██████▒▒▒▒░░░░▒░░▒░░░░░░░░░░░░░░░░░░░░▒▒░░▒▒░░░░░░▒▓▓▒▒░░░░░░░▒░░░░░░░░░░▒░▒▒▒▒▒▒▒▒▒▒▒▒▒▒▒▒▒▒▒▒▒▒▒▒▒▒▒▒▒▒▒▒▒▒▒▒▒▒▒▒▒▒▒▒▒▒▒░▒▒░░▒▒▒▒▒░░░▒▓▓▓▓▓▓▓▓▓▒▒▒▒▒▒▒▒▒▒▒▒
░░░░░░░░░░░░░░░░▒▒▒▒▒▒▒▒▒▒▒▒▒▒▒▒▒▒▒▒▒▒▒▒▒▒▒▒▒▒▒▒▒▒▒▒▒▒▒▒▒▓▓▓▓▒▓█▓▓▓█████▒▒▒▒▒▒▒▒░░░░░░░░░░░░░░░░░░░░ ░░▒░▒▒░▒▒▓▒▒▒▒░░░░░░░░░░░░░░░░░░░░▒░▒▒▒░▒░▒▒▒▒▒▒▒▒▒▒▒▒▒▒▒▒▒▒▒▒▒▒▒▒▒▒▒▒▒▒▒▒▒▒▒▒▒▒▒▒▒▒▒░░▒▒▒░▒▒▒▒░▒░░░▒▓▓▓▓▒▒▒▒▒▒▒▒▒▒▒▒▒▒
░░░░░░░░░░░░░▒▒▒▒▒▒▒▒▒▒▒▒▒▒▒▒▒▒▒▒▒▒▒▒▒▒▒▒▒▒▒▒▒▒▒▒▒▒▒▒▒▒▒▒▒▒▓▓▓▓▒▒██▓▒▓█████▓▓▒▒▒▒▒▒░░░░░░░░░░░░░░░░░░  ░░▒▒▒▒▒▒░░░░░░░░░░░░░▒░░░░░░▒▒░▒▒▒▒▒▒▒▒░░▒▒▒▒▒▒▒▒▒▒▒▒▒▒▒▒▒▒▒▒▒▒▒▒▒▒▒▒▒▒▒▒▒▒▒▒▒▒▒▒░░░░▒░░░░░░▒▒▒░░░░░░▒▓▓▓▓▒▒▒▒▒▒▒▒▒▒▒
░░░░░░░░░░▒▒▒▒▒▒▒▒▒▒▒▒▒▒▒▒▒▒▒▒▒▒▒▒▒▒▒▒▒▒▒▒▒▒▒▒▒▒▒▒▒▒▒▒▒▒▒▒▒▒▒▒▓▓▒▒▒▓▓▒▒▒▒▓███▓▒▒▒▒▒▒▒▒▒▒▒░░░░░░░░░░░░░▒▒░░▒▒░░░░░░░░░░░░░░░░░░░░░▒░▒▒▒▒▒▒▒▒▒▒▒▒▒▒▒▒▒▒▒▒▒▒▒▒▒▒▒▒▒▒▒▒▒▒▒▒▒▒▒▒▒▒▒▒▒▒▒▒▒▒▒░░░░░░░░░░░░░░░░▒▒▒░░░░░░▒▒▓▓▒▒▒▒▒▒▒▒▒
░░░░░░░░▒▒▒▒▒▒▒▒▒▒▒▒▒▒▒▒▒▒▒▒▒▒▒▒▒▒▒▒▒▒▒▒▒▒▒▒▒▒▒▒▒▒▒▒▒▒▒▒▒▒▒▒▒▒▒▒▓▓▒▒▒▒▒▒▒▓▒▒▓█▓▓▒▒▒▒▒▒▒▒▒▒▒▒░▒▒▒▒▒▒▒▒░░░░ ░▒▒░░░░░░░░░░▒▒░░░▒░▒░░▒░░▒▒▒▒▒▒▒▒▒▒▒▒▒▒▒▒▒▒▒▒▒▒▒▒▒▒▒▒▒▒▒▒▒▒▒▒▒▒▒▒▒▒▒▒▒▒▒▒▒▒▒▒░░░░░░░░░░░░░▒▒░░▒▒▒░░░░░░░░▒▒▒▒▒▒▒▒
░░░░░░░░░░▒▒▒▒▒▒▒▒▒▒▒▒▒▒▒▒▒▒▒▒▒▒▒▒▒▒▒▒▒▒▒▒▒▒▒▒▒▒▒▒▒▒▒▒▒▒▒▒▒▒▒▒▒▒▒▒▓▒▒▒▒▒▒▓▒▒▒▒▒▓▒▒▒▒▒▒▒▒▒▒▒▒▒▒▒▒▒▒▒▒▒░░░   ░▒▒░░░░░░▒▒▒▒░░▒▒▒▒▒▒░░░▒▒▒▒▒▒▒▒▒▒▒▒▒▒▒▒▒▒▒▒▒▒▒▒▒▒▒▒▒▒▒▒▒▒▒▒▒▒▒▒▒▒▒▒▒▒▒▒▒▒▒▒▒▒░░░░░░░░░░░▒▒░░░░░░▒▒▒░░░░░░░░░░░░░
░░░░░░░░░░░░▒▒▒▒▒▒▒▒▒▒▒▒▒▒▒▒▒▒▒▒▒▒▒▒▒▒▒▒▒▒▒▒▒▒▒▒▒▒▒▒▒▒▒▒▒▒▒▒▒▒▒▒▒▒▒▓▒▒▒▒▒▒▓▓▒▒▒▒▒▒▓▓▓▓▒▒▒▒▒▒▒▒▒▒▒▒▒▒▒░░░░░ ░░░▒░░░░▒▒▒▒▒▒▒▒▒▒▒░░░░▒▒▒▒▒▒▒▒▒▒▒▒▒▒▒▒▒▒▒▒▒▒▒▒▒▒▒▒▒▒▒▒▒▒▒▒▒▒▒▒▒▒▒▒▒▒▒▒▒▒▒▒▒▒▒░░░░░░░░░▒▒▒░░░░░░░░░░░░░▒░░░░░░░░░
░░░░░░░▒░░▒░▒░▒▒▒▒▒▒▒▒▒▒▒▒▒▒▒▒▒▒▒▒▒▒▒▒▒▒▒▒▒▒▒▒▒▒▒▒▒▒▒▒▒▒▒▒▒▒▒▒▒▒▒▒▒▒▓▒▒▓▓▒▒▓▓▓▓▒▒▒▒▓▓▓▓▓▒▒▒▒▓▒▒▒▒▓▓▒▒▒░░░░░░ ░░▓▒░▒▒▒▒▒▒▒▒▒▒▒▒▒▒░▒▒▒▒▒▒▒▒▒▒▒▒▒▒▒▒▒▒▒▒▒▒▒▒▒▒▒▒▒▒▒▒▒▒▒▒▒▒▒▒▒▒▒▒▒▒▒▒▒▒▒▒▒▒▒░░░░░░░░░▒▒░░░░░░░░░░  ░░░░░░░░░░░░░
░░░░░░░░░▒░▒▒▒▒▒▒▒▒▒▒▒▒▒▒▒▒▒▒▒▒▒▒▒▒▒▒▒▒▒▒▒▒▒▒▒▒▒▒▒▒▒▒▒▒▒▒▒▒▒▒▒▒▒▒▒▒▒▒▒▒▓▓▓▒▒▓▓▓▓▓▒▒▒▓▓▓▓▓▓▓▓▓▓▓▓▓▓▓▒░░▒░░░░░░░░░▓▓▒▒▒▒▒▒▒▒▒▒▒▒▒▒▒▒▒▒▒▒▒▒▒▒▒▒▒▒▒▒▒▒▒▒▒▒▒▒▒▒▒▒▒▒▒▒▒▒▒▒▒▒▒▒▒▒▒▒▒▒▒▒▒▒▒▒▒▒▒▒▒░░░░░░▒▓▒░░░░░░░░  ░░░ ░░░░░░░░░░░░
░░░░░░░░░░▒▒▒▒▒▒▒▒▒▒▒▒▒▒▒▒▒▒▒▒▒▒▒▒▒▒▒▒▒▒▒▒▒▒▒▒▒▒▒▒▒▒▒▒▒▒▒▒▒▒▒▒▒▒▒▒▒▒▒▒▒▒▓▓▓▒▒▓▓▓▓▓▒▒▓▓▓▓▓▓▓▓▓▓▓▓▓▒▒▒░░░▒░░░░░░░░░▓▓▒▒▒▒▒▒▒▒▒▒▒▒▒▒▒▒▒▒▒▒▒▒▒▒▒▒▒▒▒▒▒▒▒▒▒▒▒▒▒▒▒▒▒▒▒▒▒▒▒▒▒▒▒▒▒▒▒▒▒▒▒▒▒▒▒▒▒▒▒▒▒░░░░▒▓░░░░░░░░░ ░ ░  ░  ░░░░░░░░░░
░░░░░░░░▒▒▒░░▒░▒▒▒▒▒▒▒▒▒▒▒▒▒▒▒▒▒▒▒▒▒▒▒▒▒▒▒▒▒▒▒▒▒▒▒▒▒▒▒▒▒▒▒▒▒▒▒▒▒▒▒▒▒▒▒▒▒▒▓▓▓▒▒▓▓▓▓▒▒▒▓▓▓▓▓▓▓▓▓▓▒▒░▒░░░░░░▒░░░░░░░░▓█▒▒▒▒▒▒▒▒▒▒▒▒▒▒▒▒▒▒▒▒▒▒▒▒▒▒▒▒▒▒▒▒▒▒▒▓▒▒▒▒▒▒▒▒▒▒▒▒▒▒▒▒▒▒▒▒▒▒▒▒▒▒▒▒▒▒▒▒▒▒▒▒▒▒▒░░░░░░░░░░░░░░░      ░░░░░░░░
░░░░░░░░░░░░░▒░▒▒▒▒▒▒▒▒▒▒▒▒▒▒▒▒▒▒▒▒▒▒▒▒▒▒▒▒▒▒▒▒▒▒▒▒▒▒▒▒▒▒▒▒▒▒▒▒▒▒▒▒▒▒▒▒▒▒▒▒▓▓▒▓▓▓▓▓▒▒▓▓▓▓▓█▓▓▒▒░▒▓░░░░░░░░▒░░▒▒▒░░░▒█▒▒▒▒▒▒▒▒▒▒▒▒▒▒▒▒▒▒▒▒▒▒▒▒▒▒▒▒▒▒▒▒▒▒▒▒▒▒▒▒▒▒▒▒▒▒▒▒▒▒▒▒▒▒▒▒▒▒▒▒▒▒▒▒▒▒▒▒▒▒▒▒▒░░░░░░░░░░░░░░░ ░ ░     ░░░░ ░
░░░░░░░░░░░░░▒▒▒▒▒▒▒▒▒▒▒▒▒▒▒▒▒▒▒▒▒▒▒▒▒▒▒▒▒▒▒▒▒▒▒▒▒▒▒▒▒▒▒▒▒▒▒▒▒▒▒▒▒▒▒▒▒▒░▒▒▒▒▒▒▒▓▓▓▓▓▒▒▓▓▓▒▒▒░░░▓▒░░░░░░░░░░░▒▒▒▒▒░░░▒▓▒▒▒▒▒▒▒▒▒▒▒▒▒▒▒▒▒▒▒▒▒▒▒▒▒▒▒▒▒▒▒▒▒▒▒▒▒▒▒▒▒▒▒▒▒▒▒▒▒▒▒▒▒▒▒▒▒▒▒▒▒▒▒▒▒▒▒░░▒▒░░░░░░░░░░░░░░░░░░░░░    ░ ░ ░░
░░░░░░░░░░░▒▒▒▒▒▒▒▒▒▒▒▒▒▒▒▒▒▒▒▒▒▒▒▒▒▒▒▒▒▒▒▒▒▒▒▒▒▒▒▒▒▒▒▒▒▒▒▒▒▒▒▒▒▒▒▒▒▒▒░░▒▒▒░▒▒▒▒░▒░░░▒▒░░░░░▒▓▒░░░░░░░░░░░▒▒▒▒▒▒▒▒░░░▒▒▒▒▒▒▒▒▒▒▒▒▒▒▒▒▒▒▒▒▒▒▒▒▒▒▒▒▒▒▒▒▒▒▒▒▒▒▒▒▒▒▒▒▒▒▒▒▒▒▒▒▒▒▒▒▒▒▒▒▒▒▒▒▒▒▒▒▒▒▒▒▒▒░░░░░░░░░░░░░░░░░░░░   ░░ ░░▒
░░░░░░░░░░▒▒▒▒▒▒▒▒▒▒▒▒▒▒▒▒▒▒▒▒▒▒▒▒▒▒▒▒▒▒▒▒▒▒▒▒▒▒▒▒▒▒▒▒▒▒▒▒▒▒▒▒▒▒▒▒▒▒░▒░░▒▒▒▓▒░▒▒░░░░░▒▒░▒▒▓▓▒░░░░░░░░░░░░▒▒▒▒▒▒▒▒▒▒▒▒▒▒▒▒▒▒▒▒▒▒▒▒▒▒▒▒▒▒▒▒▒▒▒▒▒▒▒▒▒▒▒▒▒▒▒▒▒▒▒▒▒▒▒▒▒▒▒▒▒▒▒▒▒▒▒▒▒▒▒▒▒▒▒▒▒▒▒▒▒▒▒▒▒▒▒▒▒▒▒░░░░░░░░░░░░░░░░░ ░░░░▒░
░░░░░░░░▒▒▒▒▒▒▒▒▒▒▒▒▒▒▒▒▒▒▒▒▒▒▒▒▒▒▒▒▒▒▒▒▒▒▒▒▒▒▒▒▒▒▒▒▒▒▒▒▒▒▒▒▒▒▒▒▒▒▒▒▒▒░░░░░░▒▒▒▒▓▓▓▓▓▒▒▒▒░░░░░░░░░░░░░░░▒▒▒▒▒▒▒▒▒▒▒▒▒▒▒▒▒▒▒▒▒▒▒▒▒▒▒▒▒▒▒▒▒▒▒▒▒▒▒▒▒▒▒▒▒▒▒▒▒▒▒▒▒▒▒▒▒▒▒▒▒▒▒▒▒▒▒▒▒▒▒▒▒▒▒▒▒▒▒▒▒▒▒▒▒▒▒▒▒▒▒▒▒▒░░░░░░░░░░░░░░░░░░░░░ 
░░░░░░▒▒▒▒▒▒░▒▒▒▒▒▒▒▒▒▒▒▒▒▒▒▒▒▒▒▒▒▒▒▒▒▒▒▒▒▒▒▒▒▒▒▒▒▒▒▒▒▒▒▒▒▒▒▒▒▒▒▒▒▒░▒░░░░░░░░░░░░░░░░░▒▒░░░░░░░░░░░░░░░░▒▒▒▒▒▒▒▒▒▒▒▒▒▒▒▒▒▒▒▒▒▒▒▒▒▒▒▒▒▒▒▒▒▒▒▒▒▒▒▒▒▒▒▒▒▒▒▒▒▒▒▒▒▒▒▒▒▒▒▒▒▒▒▒▒▒▒▒▒▒▒▒▒▒▒▒▒▒▒▒▒▒▒▒▒▒▒▒▒▒▒▒▒▒▒▒░░░░░░░░░░░░░░ ░░▒░ 
░░░░▒▒░░░░░░▒▒▒▒░▒░▒▒▒▒▒▒▒▒▒▒▒▒▒▒▒▒▒▒▒▒▒▒▒▒▒▒▒▒▒▒▒▒▒▒▒▒▒▒▒▒▒▒▒▒▒▒▒▒▒░░░░░░░░░░░░░░░░░░▒▒░░░░░░░░░░░░░░░░▒▒▒▒▒▒▒▒▒▒▒▒▒▒▒▒▒▒▒▒▒▒▒▒▒▒▒▒▒▒▒▒▒▒▒▒▒▒▒▒▒▒▒▒▒▒▒▒▒▒▒▒▒▒▒▒▒▒▒▒▒▒▒▒▒▒▒▒▒▒▒▒▒▒▒▒▒▒▒▒▒▒▒▒▒▒▒▒▒▒▒▒▒▒▒▒▒▒▒▒░░░░░░░░░░░░▒░░░