▓▓▓▓▓▓▓▓▓▓▓██▓▓▓▓▓▓▓▓▓▓▓▓▓▓▓▒▒▒▒▒▒▒▒▒▒▒▒▒▒▒▒▒▒▒▒▓▓▓▓▓▓▓▓▓▓▓▓▓▓▓▓▓▓▓███████████████████████████████████████████▓▓▓▓▓▓▓▓▓▒▒▒▒▒▒▒▒▒▒▒▒▒▒▒▒▓▓▓▓▓▓▓▓█████████████████████████████████████████▓▓▓▓▓▓▓▓▓▓▓▓▓▒▒▒▒▒▒▒▒▓▓▓▓▓▓▓▓▓▓▓▓▓▓▓
▓▓▓▓▓▓▓▓▓▓▓▓▓▓████▓▓▓▓▓▓▓▓▓▓▓▓▓▓▒▒▒▒▒▒▒▒▒▒▒▒▒▒▒▒▒▒▒▓▓▓▓▓▓▓▓▓▓▓▓▓▓▓▓▓▓█████████████████████████████████████████▓▓▓▓▓▓▓▓▓▒▒▒▒▒▒▒▒▒▒▒▒▒▒▒▒▓▓▓▓▓▓▓▓███████████████████████████████████████▓▓▓▓▓▓▓▓▓▓▒▒▒▒▒▒▒▒▒▒▒▒▒▒▓▒▓▒▒▒▓▓▓▓▓▓▓▓
▒▒▒▓▓▓▓▓▓▓▓▓▓▓▓▓▓████▓▓▓▓▓▓▓▓▓▓▓▓▓▓▒▒▒▒▒▒▒▒▒▒▒▒▒▒▒▒▒▒▒▓▓▓▓▓▓▓▓▓▓▓▓▓▓▓▓█████████████████████████████████████████▓▓▓▓▓▓▓▓▓▒▒▒▒▒▒▒▒▒▒▒▒▒▒▒▓▓▓▓▓▓▓▓████████████████████████████████████▓▓▓▓▓▓▓▓▓▓▓▒▒▒▒▒▒▒▒▒▒▒▒▒▒▒▒▒▒▒▒▒▒▒▒▒▒▒▓▓▓
▒▒▒▒▒▒▒▓▓▓▓▓▓▓▓▓▓▓▓▓▓█████▓▓▓▓▓▓▓▓▓▓▓▓▒▒▒▒▒▒▒▒▒▒▒▒▒▒▒▒▒▒▓▓▓▓▓▓▓▓▓▓▓▓▓▓▓████████████████████████████████████████▓▓▓▓▓▓▓▓▓▒▒▒▒▒▒▒▒▒▒▒▒▒▒▒▒▓▓▓▓▓▓▓▓█████████████████████████████████▓▓▓▓▓▓▓▓▓▒▒▒▒▒▒▒▒▒▒▒▒▒▒▒▒▒▓▓▓▓▓▓▓▓▓▓▓▓▓▓▓▓▓
▓▒▒▒▒▒▒▒▒▒▒▓▓▓▓▓▓▓▓▓▓▓▓▓████▓▓▓▓▓▓▓▓▓▓▓▓▓▒▒▒▒▒▒▒▒▒▒▒▒▒▒▒▒▒▒▒▓▓▓▓▓▓▓▓▓▓▓▓▓██████████████████████████████████████▓▓▓▓▓▓▓▓▓▒▒▒▒▒▒▒▒▒▒▒▒▒▒▒▒▓▓▓▓▓▓▓▓▓█████████████████████████████▓▓▓▓▓▓▓▓▓▓▓▓▓▓▓▓▓▓▓▓▓▓▓▓▓▓▓▓▓▓▓▓▓▓▓▓▓█████████
▓▓▓▓▓▓▒▒▒▒▒▒▒▒▒▓▓▓▓▓▓▓▓▓▓▓▓▓████▓▓▓▓▓▓▓▓▓▓▓▓▒▒▒▒▒▒▒▒▒▒▒▒▒▒▒▒▒▓▓▓▓▓▓▓▓▓▓▓▓▓▓████████████████████████████████████▓▓▓▓▓▓▓▓▓▓▒▒▒▒▒▒▒▒▒▒▒▒▒▒▒▒▓▓▓▓▓▓▓▓▓▓█████████████████████████████▓▓▓▓▓▓▓▓▓▓▓▓▓▓▓▓▓▓▓▓▓▓▓▓▓▓█▓████████████████
▓▓▓▓▓▓▓▓▓▓▒▒▒▒▒▒▒▒▒▓▓▓▓▓▓▓▓▓▓▓▓▓███▓▓▓▓▓▓▓▓▓▓▓▓▒▒▒▒▒▒▒▒▒▒▒▒▒▒▒▒▒▓▓▓▓▓▓▓▓▓▓▓▓▓▓██████████████████████████████████▓▓▓▓▓▓▓▓▒▒▒▒▒▒▒▒▒▒▒▒▒▒▒▒▒▒▓▓▓▓▓▓▓▓▓▓▓▓██████████████████████████████████▓█▓▓█▓█▓████████████████████████████
▓▓▓▓▓▓▓▓▓▓▓▓▓▓▒▒▒▒▒▒▒▒▒▓▓▓▓▓▓▓▓▓▓▓▓▓██▓▓▓▓▓▓▓▓▓▓▓▒▒▒▒▒▒▒▒▒▒▒▒▒▒▒▒▒▓▓▓▓▓▓▓▓▓▓▓▓▓▓███████████████████████████████▓▓▓▓▓▓▒▒▒▒▒▒▒▒▒▒▒▒▒▒▒▒▒▒▒▒▒▓▓▓▓▓▓▓▓▓█████████████████████████████████████████████████████████████████████████
▓▓▓▓▓▓▓▓▓▓▓▓▓▓▓▓▓▓▓▒▒▒▒▒▒▒▒▓▓▓▓▓▓▓▓▓▓▓▓▓██▓▓▓▓▓▓▓▓▓▓▓▒▒▒▒▒▒▒▒▒▒▒▒▒▒▒▒▓▓▓▓▓▓▓▓▓▓▓▓▓▓██████████████████████████▓▓▓▓▓▓▓▒▒▒▒▒▒▒▒▒▒▒▒▒▓▓▓▓▓▓▓▓▓▓▓▓▓████████████████████████████████████████████████████████████████████▓▓▓▓▓▓▓▓▓▓
▓▓▓▓▓▓▓▓▓▓▓▓▓▓▓▓▓▓▓▓▓▓▓▒▒▒▒▒▒▒▒▓▓▓▓▓▓▓▓▓▓▓▓█▓▓▓▓▓▓▓▓▓▓▓▓▒▒▒▒▒▒▒▒▒▒▒▒▒▒▒▒▓▓▒▓▓▓▓▓▓▓▓▓▓▓███████████████████████▓▓▓▓▓▓▓▓▓▓▓▓▓▓▓▓▓▓▓▓▓▓▓▓▓▓▓█████████████████████████████████████████████████████▓▓▓▓▓▓▓▓▓▓▓▓▓▓▓▓▓▓▓▓▓▓▓▓▓▓▓▓▓▓▓
▓▓▓▓▓▓▓▓▓▓▓▓▓▓▓▓▓▓▓▓▓▓▓▓▓▓▓▓▒▒▒▒▒▒▒▓▓▓▓▓▓▓▓▓▓▓▓▓▓▓▓▓▓▓▓▓▓▓▒▒▒▒▒▒▒▒▒▒▒▒▒▒▒▒▒▒▒▒▓▓▓▓▓▓▓▓▓▓▓████████████████████████████████████████████████████████████████████████████████████▓▓▓▓▓▓▓▓▓▓▓▓▓▓▓▓▓▓▓▓▓▓▓▓▓▓▓▓▓▓▓▓▓▓▓▓▒▒▒▒▒▒▒▒▒▒▒
████▓▓█▓▓▓▓▓▓▓▓▓▓▓▓▓▓▓▓▓▓▓▓▓▓▓▓▓▒▒▒▒▒▒▒▓▓▓▓▓▓▓▓▓▓▓▓▓▓▓▓▓▓▓▓▓▓▒▒▒▒▒▒▒▒▒▒▒▒▒▒▒▒▒▓▓▓▓▓▓▓▓█████████████████████████████████████████████████████████████████████▓▓▓▓▓▓▓▓▓▓▓▓▓▓▓▓▓▓▓▓▓▓▓▓▓▓▓▓▓▓▓▓▓▓▓▓▓▓▓▒▒▒▒▒▒▒▒▒▒▒▒▒▒▒▒▒▒▒▒▒▒▒▒▒▒
█████████▓██▓▓▓█▓▓▓▓▓▓▓▓▓▓▓▓▓▓▓▓▓▓▓▓▒▒▒▒▒▒▒▓▓▓▓▓▓▓▓▓▓▓▓▓▓▓▓▓▓▓▓▓▒▒▒▒▒▒▒▒▓▓▓▓▓▓▓▓▓▓▓██████████████████████████████████████████████████▓▓▓▓▓▓▓▓▓▓▓▓▓▓▓▓▓▓▓▓▓▓▓▓▓▓▓▓▓▓▓▓▓▓▓▓▓▓▓▓▓▓▓▓▓▓▓▓▓▒▒▒▒▒▒▒▒▒▒▒▒▒▒▒▒▒▒▒▒▒▒▒▒▒▒▒▒▒▒▒▒▒▒▒▒▒▒
███████████████▓██▓▓▓▓▓▓▓▓▓▓▓▓▓▓▓▓▓▓▓▓▓▓▓▒▒▒▒▒▒▓▓▓▓▓▓▓▓▓▓▓▓▓▓▓▓▓▓▓▒▒▒▓▓▓▓▓▓▓▓▓▓▓▓████████████████████████████████████▓▓▓▓▓▓▓▓▓▓▓▓▓▒▒▓█████████▓▓▓▓▓▓▓▓▓▓▓▓▓▓▓▓▓▓▓▓▓▓▓▓▓▒▒▒▒▒▒▒▒▒▒▒▒▒▒▒▒▒▒▒▒▒▒▒▒▒▒▒▒▒▒▒▒▒▒▒▒▒▒▒▒▒▒▒▒▒▒▒▒▒▒▒▒▒
▓▓▓▓▓█████████████████▓▓▓▓▓▓▓▓▓▓▓▓▓▓▓▓▓▓▓▓▓▓▓▒▒▒▒▒▒▓▓▓▓▓▓▓▓▓▓▓▓▓▓▓▓▓▓▓▓▓▓▓▓▓▓▓███████████████████████████████████▓▓▓▓▓▓▓▓▓▓▓▓▓▓▓▓▓▓▒▓▓▓▓▓▓▓▓▓▓▓▓▓▓▓▒▓▒▒▒▒▒▒▒▒▒▒▒▒▒▒▒▒▒▒▒▒▒▒▒▒▒▒▒▒▒▒▒▒▒▒▒▒▒▒▒▒▒▒▒▒▒▒▒▒▒▒▓▓▓▓▓▓▓▓▓▓▓▓▓▓▓▓▓▓▓▓▓
▓▓▓▓▓▓▓██████████████████▓▓▓▓▓▓▓▓▓▓▓▓▓▓▓▓▓▓▓▓▓▓▓▓▒▒▒▒▒▒▓▓▓▓▓▓▓▓▓▓▓▓▓▓▓▓▓▓▓▓▓▓▓▓▓▓▓▓▓▓▓▓▓▓▓▓█████████████████████▓▓▓▓▓▓▓▓▓▓▓▒▒▒▒▒▒▒▒▒▒▒▓▓▓▓▓▓▓▒▒▒▒▒▒▒▒▒▓▒▒▓▒▓▓▓▓▓▓▓▓▓▓▓▓▓▓▓▓▓▓▓▓▓▓▓▓▓▓▓▓▓▓▓▓▓▓▓▓▓▓▓▓▓▓▓▓▓▓▓▓▓▓▓██████████████
▒▓▓▓▓▓▓█████▓▓▓▓▓▓███████████▓▓▓▓▓▓▓▓▓▓▓▓▓▓▓▓▓▓▓▓▓▓▓▓▓▒▒▒▒▒▓▓▓▓▓▓▓▓▓▓▓▓▓▓▓▓▓▓▓▓▓▓▓▓▓▓▓▓▓▓▓▓▓▓▓▓▓▓▓▓▓▓▓▓▓▓▓▓▓▓▓▓▓▓▓▓▓▒▒▒▒▒▒▒▒▒▒▒▒▒▒▒▒▒▒▒▒▒▒▒▒▒▓▓▓▓▓▓▓▓▓▓▓▓▓▓▓▓▓▓▓▓▓▓▓████████████████████████████████████████████████████████
▒▒▒▒▒▒▒▓▓▓▓██▓▓▓▓▓▓▓▓▓▓▓▓████████▓█▓▓▓▓▓▓▓▓▓▓▓▓▓▓▓▓▓▓▓▓▓▓▓▒▒▒▒▒▒▓▓▓▓▓▓▓▓▓▓▓▓▓▓▓▓▓▓▓▓▓▓▓▓▓▓▓▓▓▓▓▓▓▓▓▓▓▓▓▓▓▓▓▓▓▓▓▓▓▓▓▓▓▓▓▓▓▓▓▓▓▓▓▓▓▓▓▓▓▓▓▓▓▓██████████████████████████████████████████████████████████████████████████████████
█▓▓▓▓▒▒▒▒▒▒▒▒▒▓▓▓▓▓▓▓▓▓▓▓▓▓▓▓▓████████▓█▓▓▓▓▓▓▓▓▓▓▓▓▓▓▓▓▓▓▓▓▓▒▒▒▒▒▒▒▒▒▒▒▒▒▒▒▒▒▒▒▓▓▓▓▓▓▓▓▓▓▓▓▓▓▓▓▓▓▓▓████████████████████████████████████████████████████████████████████████████████████████████████████████████████████████
██████▓▓▓▓▒▒▒▒▒▒▒▒▒▒▒▒▓▓▓▓▓▓▓▓▓▓▓▓▓▓▓███████▓▓▓▓▓▓▓▓▓▓▓▓▓▓▓▓▓▓▓▒▒▒▒▒▒▒▒▒▒▓▓▓▓▓▓▓▓▓▓▓▓▓▓▓▓███████████████████████████████████████████████████████████████████████████████████████████████████████████████████████████████████
█████████▓▓▓▓▓▓▒▒▒▒▒▒▒▒▒▒▒▒▒▓▓▓▓▓▓▓▓▓▓▓▓▓▓██████▓▓▓▓▓▓▓▓▓▓▓▓▓▓▓▓▓▒▒▓▓▓▓▓▓▓▓▓▓▓▓▓▓▓▓█████████████████████████████████████████████████████████████████████████████████████████████████████████████████████████████████████████
█████████████▓▓▓▓▓▓▒▒▒▒▒▒▒▒▒▒▒▒▒▒▒▒▒▓▓▓▓▓▓▓▓▓▓██████▓▓▓▓▓▓▓▓▓▓▓▓▓▓▓▓▓▓▓▓▓▓▓▓▓▓▓▓████████████████████████████████████████████████████████████████████████████████████████████████████████████▓▓▓▓▓▓▓▓▓▓▓▓▓▓▓▓▓▓▓▓▓▓▓▓▓▓▓▓▓▓▓▓
█████████████████▓▓▓▓▓▓▓▒▒▒▒▒▒▒▒▒▓▓▓▓▓▓▓▒▒▓▓▓█████████▓▓▓▓▓▓▓▓▓▓▓▓▓▓▓▓▓▓▓▓▓▓▓▓▓██████████████████████████████████████████████████████████████████████████████████████████████████▓██▓█▓▓▓▓▓▓▓▓▓▓▓▓▓▓▓▓▓▓▓▓▓▓▓▓▓▓▓▓▓▓▓▓▓▓▓▓▓▓
█████████████████▓▓▓▓▓▓▓▓▓▓▓▓▓▓▓▓▓▓███████▓▓▓▓▓▓▓▓▓█▓▓▓▓▓▓▓▓▓▓▓▓▓▓▓▓▓▓▓▓▓▓▓▓▓████████████████████████████████████████████████████████████████████████████████████████████████████████▓█▓▓▓▓▓▓█▓█▓█▓▓▓▓▓▓▓▓▓▓▓▓▓▓▓▓▓▓▓▓▓▓▓▓▓▓
█████████████▓▓▓▓▓▓▓▓▓▓▓▓▓▓▓▓▓▓▓███████████████▓▓▓▒▒▒▒▒▒▒▒▒▒▒▒▒▒▓▒▒▒▒▒▓▒▒▒▒▓▓▓▓▓▓▓▓▓▓▓▓▓▓▓▓▓▓████████████████████████████████████████████████████████████████████████████████████████████████████████████▓██▓▓▓▓▓▓▓▓▓▓▓▓▓▓▓▓
█████████████▓▓▓▓▓▓▓▓▓▓▓▓▓▓▓▓▓▓▓▓████████████████▓▓▓▓▒▒▒▒▒▒▒▒▒▓▓▒▒▓▒▓▒▒▒▒▒▓▒▓▓▓▓▓▓▓▓▓▓▓▓▓▓▓▓███████████████████████████▓▓▓▓▓▓▓▓▓▓▓▓▓▓▓▓▓▓▓▓▓▓▓▓▓▓▓▓▓▓▓▓▓▓▓▓█████████████████████████████████████████████▓██▓███▓▓▓▓▓▓▓▓▓▓▓▓▓
███████████████▓▓▓▓▓▓▓▓▓▓▓▓▓▓▓▓▓▓▓▓███████████████▓▓▓▓▓▒▒▒▓▓▓▓▓▓▓▓▓▓▓▓▓▓▓▓▒▒▓▓▓▓▓▓▓▓▓▓▓▓▓▓▓▓▓▓▓▓▓▓▓▓▓▓▓▓▓▓▓▓▓████████████████████████████████████████████▓▓████████████████████████████████████████████████▓█▓█▓▓▓▓▓▓▓▓▓▓▓▓▓
███████████████▓▓▓▓▓▓▓▓▓▓▓▓▓▓▓▓▓▓▓▓▓▓▓███████████▓▓▓▓▓▓▓▓▓▓▓▓▓▓▓▓▓▓▓▓▓▓▓▓▓▓▓█████████████████████████████████████████████████████████████████████████████▓▓██████████████████████████████████████████████████▓▓▓▓███▓▓▓▓▓▓▓▓
████████████████▓▓▓▓▓▓▓▓▓▓▓▓▓▓▓▓▓▓▓▓▓███████████▓▓▓▓▓▓▓▓▓▓▓▓▓▓▓▓▓▓▓▓▓▓▓▓▓▓▓▓█████████████████████████████████████████████████████████████████████████████▓▓█████████████████████████████████████████████████████▓▓▓▓█▓▓▓▓▓▓▓
█████████████████▓▓▓▓▓▓▓▓▓▓▓▓▓▓▓▓▓▓▓██████████████▓▓▓▓▓▓▓▓▓▓▓▓▓▓▓▓▓▓▓▓▓▓▓▓▓▓█████████████████████████████████████████████████████████████████████████████▓▓████████████████████████████████████████████████▓██▓▓█▓▓▓▓▓▓▓▓▓▓▓
███████████████████▓▓▓▓▓▓▓▓▓▓▓▓▓▓▓▓███████████████▓▓▓▓▓▓▓▓▓▓▓▓▓▓▓▓▓▓▓▓▓▓▓▓▓▓█████████████████████████████████████████████████████████████████████████████▓▓████████████████████████████████████████████████▓█▓▓▓▓█▓▓▓▓▓▓▓▓▓▓
███████████████████▓▓▓▓▓▓▓▓▓▓▓▓▓▓▓█████████████████▓▓▓▓▓▓▓▓▓▓▓▓▓▓▓▓▓▓▓▓▓▓▓▓▓█████████████████████████████████████████████████████████████████████████████▓▓███████████████████████████████████████████████████▓▓▓▓▓▓▓▓▓▓▓▓▓▓
██████████████████▓▓▓▓▓▓▓▓▓▓▓▓▓▓▓▓██████████████████▓▓▓▓▓▓▓▓▓▓▓▓▓▓▓▓▓▓▓▓▓▓▓▓█████████████████████████████████████████████████████████████████████████████▓▓████████████████████████████████████████████▓██▓█▓█▓▓▓▓▓▓▓▓▓▓▓▓▓▓
████████████████████▓▓▓▓▓▓▓▓▓▓▓▓▓███████████████████▓▓▓▓▓▓▓▓█▓█▓▓▓▓▓▓▓▓▓▓▓▓▓█████▓▓██████▓▒▓██████▒▒▓████████████████████▓▓████████████▓▒▓████▒▒▓████████▓▓███████████████████████████████████████████████▓█▓█▓▓▓▓▓▓▓▓▓▓▓▓▓▓
█████████████████████▓▓▓▓▓▓▓▓▓▓▓█████████████████████▓▓▓▓▓███████▓▓▓▓▓▓▓▓▓▓▓████▓▒░▓█████▒░▒██████▓▒▓███████████████████▓░░▓███████████▓▒▒████▒▒▓████████▒▓█████████████████████████████████████████████▓█▓▓▓▓▓▓▓▓▓▓▓▓▓▓▓▓▓▓
████████████████████▓▓▓▓▓▓▓▓▓▓▓███████████████████████▓▓▓█████████▓▓▓▓▓▓▓▓▓▓█████████████████████████████████████████████████████████████████████████████▒▓███████████████████████████████████████████▓█▓▓█▓██▓▓▓▓▓▓▓▓▓▓▓▓▓▓
█████████████████████▓▓▓▓▓▓▓▓▓▓████████████████████████▓███████████▓▓▓▓▓▓▓▓██████████████████████████████████████████████████████████████████████████████▒▓██████████████████████████████████████████████▓▓█▓▓▓▓▓▓▓▓▓▓▓▓▓▓▓▓
████████████████████▓▓▓▓▓▓▓▓▓▓▓████████████████████████▓████████████▓▓▓▓▓▓▓██████████████████████████████████████████████████████████████████████████████▒▓█████████████████████████████████████████████▓█▓▓▓▓▓▓▓▓▓▓▓▓▓▓▓▓▓▓
██████████████████████▓▓▓▓▓████████████████████████████▓█████████████▓▓▓▓▓▓█████▓▒ ▒█████░ ▒██████▒ ▒█████░ ▓███████▒ ░█████▓ ░██████████████▓▒ ▒████████▒▓████████████████████████████████████████████▓█▓▓▓▓▓▓▓▓▓▓▓▓▓▓▓▓▓▓▓
██████████████▓▓▓▓▓▓▓▓▓▓▓▓▓▓▓▓▓▓▓▓████████▓▓▓▓▓▓▒▒▒▒▒▒▒▓█████████████▓▓▓▓▓▓████████████████████████▓██████▓▓█████████▓▓█████▓▓▓███████████████▓▓█████████▒▓███████████████████████████████████████████▓█▓▓▓▓▓▓▓▓▓▓▓▓▓▓▓▓▓▓▓▓
████████████▓▓▓▓▓▓▓▓▓▓▓▒▒▒▒▒▒▒▒▒▒▒▒▒▒▒▒▒▒▒▒▒▒▒▒░░░░░▒▒▒▓█████████████▓▓▓▓▓▓██████████████████████████████████████████████████████████████████████████████▒▓█████████████████████████████████████████▓██▓▓█▓█▓▓▓▓▓▓▓▓▓▓▓▓▓▓▓▓
▓▒▒▒▒▒▒▒▒▒▒▒▒▒▒▒▒▒▒▒▒▒▒▒▒▒▒▒▒▒▒▒▒▒▒▒▒▒▒▒▒▒▒▒▒▒▒▒░░▒▒▒▒▒▓▓▓███████████▓▓▓▓▓▓██████████████████████████████████████████████████████████████████████████████▒▓██████████████████████████████████████████▓▓█▓▓▓▓▓▓▓▓▓▓▓▓▓▓▓▓▓▓▓▓
▒▒▒▒▒▒▒▒▒▒▒▒▒▒▒▒▒▒▒▒▒▒▒▒▒▒▒▒▒▒▒▒▒▒▒▒▒▒▒▒▒▒▒▒▒▒▒▒▒▒▒▒▒▒▓▓▓▓██████████▓▓▓▓▓▓▓██████████████████████████████████████████████████████████████████████████████▒▓███████████████▓██▓▓███████▓▓▓▓█████████▓▓█▓▓▓▓▓▓▓▓▓▓▓▓▓▓▓▓▓▓▓▓▓▓
▒▒▒▒▒▒▒▒▒▒▒▒▓▒▓▓▓▓▓▓▓▓▒▒▒▒▒▒▒▒▒▒▒▒▒▒▒▒▒▒▒▒▒░░░░░▒░░▒▒░▒▒▒▒▒▓▓▓██▓▓▓▓▓▓▓▓▓▓▓██████████████████████████████████████████████████████████████████████████████▒▓████████▓███▓▓██▓▓█▓▓▓▓▓▓▓█▓█▓▓█▓████▓▓▓▓▓▓▓▓▓▓▓▓▓▓▓▓▓▓▓▓▓▓▓▓▓▓▓▓
▒▓▒▓▓▓▓▓▓▓▓▓▓▓▓▓▓▓▓▓▓▓▓▓▓▒▒▒▒▒▒▒▒▒▒▒░░░░░░░░░░░░▒▒▒░░░░░▒░░░▒▓▓▓▓▓▓▓▓▓▓▓▓▓▓██████████████████████████████████████████████████████████████████████████████▒▓████████▓█████▓▓▓█▓▓▓▓▓▓▓▓▓▓▓███▓▓▓▓▓▓▓▓▓▓▓▓▓▓▓▓▓▓▓▓▓▓▓▓▓▓▓▓▓▓▓▓▓
▒▒▓▓▓▓▓▓▓▓▓▓▓▓███▓▓▓▓▓▓▓▓▒▒▒▒▒▒▒▒▒▒▒░░░░░░░░░░░░▒▒▒░░░░░░░ ░░▓▓▓▓▓▓▓▓▓▓▓▓▓▓██████████████████████████████████████████████████████████████████████████████▒▓███████▓▓█▓▓█▓█▓▓▓▓▓▓▓▓▓▓▓▓▓▓▓▓██▓▓▓▓▓▓▓▓▓▓▓▓▓▓▓▓▓▓▓▓▓▓▓▓▓▓▓▓▓▓▓▓
▓▓▓▓▓▓▓▓▓█████████▓▓▓▓▓▓▓▒▒▒▒▒▒▒▒▒▒▒░░░░░░░░░░░░▒▒▒ ░░░░░░░ ░▒▓▓▓▓▓▓▓▓▓▓▓▓▒▒▒▓▓▓▓████████████████████████████████████████████████████████████████████████▒▓██▓██▓▓▓▓▓██▓▓▓▓▓▓▓▓▓▓▓▓▓▓▓▓▓▓▓▓▓▓▓▓▓▓▓▓▓▓▓▓▓▓▓▓▓▓▓▓▓▓▓▓▓▓▓▓▓▓▓▓▓
▓▓▓▓▓▓▓▓▓████████▓▓▒▒▒▒▒▒▒▒▒▒▒▒▒▒▒▒▒▒▒▒▒▒▒▒▒▒▒░░░▒░░░░░░░▒▒▒▒▒▒▓▓▓▓▓▓▓▓▓▓▓▓▓▓▓▓▓▓▓▓▓▓▓▓▒▒▒▒▒▒▒▒▒▒▒▒▒▓▓▓▓█████████████████████████████████████████████████▒▓▓▓▓▓▓▓▓▓▓▓▓▓▓▓▓▓▓▓▓▓▓▓▓▓▓▓▓▓▓▓▓▓▓▓▓▓▓▓▓▓▓▓▓▓▓▓▓▓▓▓▓▓▓▓▓▓▓▓▓▓▓▓▓▓▓
▓▓▓▒▒▒▒▓▓███▓▓▓▓▓▒▒▒░▒▒▓▓▓▓▓▒▒░░░░▒▒░░░▒▒▒▒▒▒▒▒▒▒▒░░░▒▒▒▒▓▓▓▓▓▒▓▓▓▓▓▓▓▓▓▓▓▓▒▒▒▒▒▒▒▒▓▓▓▓▓█▓▓▓▓▓▓▓▓▓▓▓▓▓▓▓▓▓▓▓▓▓▒▒▒▒▒▒▒▒▒▒▒▒▒▓▓▓▓█████████████████████████▓▒▓▓▓▓▓▓▓▓▓▓▓▓▓▓▓▓▓▓▓▓▓▓▓▓▓▓▓▓▓▓▓▓▓▓▓▓▓▓▓▓▓▓▓▓▓▓▓▓▓▓▓▓▓▓▓▓▓▓▓▓▓▓▓▓▓▓
▒▓▒░▒▓░▓██▓▒▒▒▒▒▒▒▒▒░▒▒▒▒▒▒▒▒▒▒▒▒▒▒▒▒▒▒▒▒▒░░░░░░▒▒▒▓▓▓▒▓▓▓▓▓▓▓▒▒▒▒▒▒▒▒▓▓▓▓▓▓▒▒▓▒▒▓▓▒▓▓▓▓▓▓▓▓▓▓▓▓▓▓▓█▓█▓███████████▓▓█████▓▓▓▓▓▓▓▒▒▒▒▒▒▒▒▒▒▒▒▒▒▒▒▒▓▓▓▓▓██▓▒▓▓▓▓▓▓▓▓▓▓▓▓▓▓▓▓▓▓▓▓▓▓▓▓▓▓▓▓▓▓▓▓▓▓▓▓▓▓▓▓▓▓▓▓▓▓▓▓▓▓▓▓▓▓▓▓▓▓▓▓▓▓▓▓▓▓
███████████▓▒▒▓▓▒▒▒▒▒▒▒▒▒▒▒▒▒▒▒▒▒▒▒▒▒░░░░░░░▒▒▒▓▓▒▒▒▓▓▓▓▓▓▓▓▓▓▒▒▒▒▒▒▒▒▒▒▒▒▒▒▒▒▒▒▒▓▒▒▒▒▒▒▒▒▓▓▒▓▓▓▓▓▓▓▓▓▓▓████████▓▒▓▓▒▒▒▒▓▓▓▓█████████████▓█▓▓▓▓▓▓▓▓▓▒▒▒▒▒▒▓▓▓▓▓▓▓▓▓▓▓▓▓▓▓▓▓▓▓▓▓▓▓▓▓▓▓▓▓▓▓▓▓▓▓▓▓▓▓▓▓▓▓▓▓▓▓▓▓▓▓▓▓▓▓▓▓▓▓▓▓▓▓▓▓▓
█████▒▓▓▓▓▓▒▒▓▓▓▓▓▓▓▓▓▓▓▓▒▒▒▒▒▒░░░░░░░▒▒▓▓████▓▓▓▓▓▓▓▓▓▓▓▓▓▓▓▒▒▒▒▒▒▒▒▒▒▒▒▒▒▒▒▒▒▒▒▒▒▒▒▒▒▒▒▒▒▒▒▒▒▒▒▒▒▒▒▓▓▓▓▓▓▓▓▓▓▓▓▓▓▓▓▓▓▓▒▓▓▓▓██████████████████▓███████▓▓▓▓▓▓▓▓▓▓▓▓▓▓▓▓▓▓▓▓▓▓▓▓▓▓▓▓▓▓▓▓▓▓▓▓▓▓▓▓▓▓▓▓▓▓▓▓▓▓▓▓▓▓▓▓▓▓▓▓▓▓▓▓▓▓▓▓▓
█████▒▒▒▓▓▓▓▓▓▓▓▓█▓▓▓▓▒▒░░░░░░░▒▒▒▓████████▓▒▒▒▓▓▓▓▓▓▓▓▓▓▓▓▓▓▒▒▒▒▒▒▒▒▒▒▒▒▒▒▒▒▒▒▒▒▒▒▒▒▒▒▒▒▒▒▒▒▒▒▒▒▒▒▒▒▒▒▒▒▒▒▒▒▒▒▓▒▒▒▒▒▓▓▓▓▓▓▓▓▓▓██▓█████████▓▓▓▓▓▓▓▓▓▓▓▓████▓▓▓▓▓▓▓▓▓▓▓▓▓▓▓▓▓▓▓▓▓▓▓▓▓▓▓▓▓▓▓▓▓▓▓▓▓▓▓▓▓▓▓▓▓▓▓▓▓▓▓▓▓▓▓▓▓▓▓▓▓▓▓▓▓
▓▓▓▓▓▒▒▓▓▓▓▒▓▓▓▒▒░░░░░░░░▒▒▓▓██████████████▓▓▓▓▓▓▓▓▓▓▓▓▓▓▓▓▓▓▒▒▒▒▒▒▒▒▒▒▒▒▒▒▒▒▒▒▒▒▒▒▒▒▒▒▒▒▒▒▒▒▒▒▒▒▒▒▒▒▒▒▒▒▒▒▒▒▒▒▒▒▒▒▒▒▒▒▒▒▒▒▒▓▒▒▓▓▓▓▓▓▓▓▓▓▓▓▓▓▓▓▓▓▓▓▓▓▓▓█▓▓▓█▓▓▓▓▓▓▓▓▓▓▓▓▓▓▓▓▓▓▓▓▓▓▓▓▓▓▓▓▓▓▓▓▓▓▓▓▓▓▓▓▓▓▓▓▓▓▓▓▓▓▓▓▓▓▓▓▓▓▓▓▓▓▓▓
▓▓▓▓▓▒▒▒▒▒▒░░░▒▒▒▓▓▓▒░▒▒▓███████████▓██████▓▓█▓▓▓▓▓▓▓▓▓▓▓▓▓▓▓▒▒▒▒▒▒▒▒▒▒▒▒▒▒▒▒▒▒▒▒▒▒▒▒▒▒▒▒▒▒▒▒▒░▒▒▒▒▒▒▓▓▒▒▒▒▒▒▒▒▒▒▒▒▒▒▒▒▒▒▒▒▒▒▒▒▒▒▒▒▒▒▒▒▒▒▒▒▒▒▓▒▒▓▒▒▒▒▒▒▒▓▓▓▓█▓▓▓▓▓▓▓▓▓▓▓▓▓▓▒▓▓▓▓▓▓▓▓▓▓▓▓▓▓▓▓▓▓▓▓▓▓▓▓▓▓▓▓▓▓▓▓▓▓▓▓▓▓▓▓▓▓▓▓▓▓▓▓
▒▒▒▒▒▒▒▒▒▒▓▓▓▓▓▓▓▓▓▓▒▒▒▒▓█████████████████████▓▓▓▓▓▓▓▓▓▓▓▓▓▓▓▒▒▒▒▒▒▒▒▒▒▒▒▒▒▒▒░▒▒▒▒▒▒▒▒▒▒▒▒▒▒▒░░▒▒▒▒▒▒████▒▒▒▒▒▒▒▒░▒▒▒▒▒▒▒▒▒▒▒▒▒▒▒▒▒▒▒▒▒▒▒▒▒▒▒▒▒▒▒▒▒▒▒▒▒▒▒▒▒▒▓▒▒▒▓▒▒▒▒▒▒▒▒▒▒▒▒▒▒▓▓▓▓▓▓▓▓▓▓▓▓▓▒▓█▓▒▒▒▒▒▒▒▒▒▒▒▓▓▓▓▓▓▓▓▓▓▓▓▓▓▓▓▓
▒▒▒▓▓▓▓▓▓▓▓▓▓▓▓▓▓▓▓▓▒▒▒▒▓█████████████████████▓▓▓▓▓▓▓▓▓▓▓▓▓▓▓▒▒▒▒▒▒▒▒▒▒▒▒▒▒▒▒▒▒▒▒▒▒▒▒▒░░▒▒▒▒▒░░▒▒▒▒▒▒▒▒▒▒▒▒▒▒▒▒▒▒░▒▒▒▒▒▒▒▒▒▒▒▒▒▒▒▒▒▒▒▒▒▒▒▒▒▒▒▒▒▒▒▒▒▒▒▒▒▒▒▒▒▒▒▒▒░▒▒▒▒▒▒▒▒▒▒▒▒▒▒▒▒▒▒▒▒▒▒▒▒▒▒▒▒▓▓▒▒▒▒▓▓▓▓▓▓▓▒▓▓▓▓▓▒▓▓▓▓▓▓▓▓▓▓▓▓
███▓▓▓▓▓▓▓▓▓▓▓▓▓▓▓▓▓▒▒▒▒▓█████████████████████▓▓▓▓▓▓▓▓▓▓▓▓▓▓▒▒▒▒▒▒▒▒▒▒▓▒▓▓▒▒▒▒▒▒▒▒▒░▒▒░░▒▒▒▒░░░░▒▒▒▒▒▒▒▒▒▒▒▒▒░▒░▒░▒▒░▒▒▒▒▒▓█▒▒▒▒▒▒▒▒▒▒▒▒▒▒▒▒▒▒▒▒▒▒▒▒▒▒▒▒▒▒▒▒▒▒▒▒░▒▒▒▒▒▒▒▒▒▒▒▒░▒▒▒▒▒▒▒▒▒▒▒▒▒▒▒▒▒▒▒▒▓▒▒▒▒▒▒▒▒▒▒▒▒▒▒▒▒▒▒▒▒▒▒▓▓▓
███▓▓▓▓▓▓▓▓▓▓▓▓▓▓▓▓▓▒▒▒▒▓█████████████████████▒▓▓▓▓▓▓▓▓▓▓▓▓▓▒▒░▒▒▒▒▒▒▒▒▒▒▒▒▒▒▒▒░▒▒▒▒▒▒▒▒▒▒▒▒░░░░░░▒░▒▒▒░▒▒▒▒░░▒░▒░▒▒░▒▒▒▒▒▒▒▓█▓▒▒▒▒▒▒▒▒▒▒▒▒▒▒▒▒░▒▒▒░▒▒▒▒▒▒▒▒▒▒▒░░▒▒▒▒▒▒▒▓█▓▓▓▓▓▓▓▓▓▓▓▓▓▓▓▓▒▒░▒▒░░▒▒░░░░░▒▒░▒▒░░░░▒▒░░░░░░░░░
███▓▓▓▓▓▓▓▓▓▓▓▓▓▓▓▓▓▒▒▒▒▓█████████████████████▒▓▓▓▓▓▓▓▓▓▓▓▓▒▒░░░░▒▒▒▒▒▒▒▒▒▒░░▒▒▒▒▒▒▒▒▒▒▒▒▒▒▒▒░░░▒░░▒░▒░░░░░░░░░░▒░▒▒░▒▒▒▒▒▒▒▒▒▓█▓▒▒▒▒▒▒░▒▒▒░▒▒▒░▒▒░░░▒▒▒▒▒▒▒▒░▒░░▒▒▒▒▒▒█▓▒▒▒▒▒▒▓▒▒▒▒▒▒▒▒▒▒▒▒▒▓▒▒░░▒▒░░░░░░░░▒▒▒▒▒▓▒▒▒░░░░░░░
███▓▓▓▓▓▓▓▓▓▓▓▓▓▓▓▓▓▒▒▒▒█████████████████████▓▒▓▓▓▓▓▓▓▓▒▒▒░░░░░░▒░▒▒▒▒▒▒▒▒▒▒▒▒▒▒▒▒▒▒▒▒▒▒▒▒▒▒░░░░░░░░░░░░░░░░░▒▒▒▒▒▒▒▒▓▒▒▒▒▒░░▒▓▒██▒▒▒▒░░░░▒░░▒▒░▒▒░░░▒▒▒▒▒▒▒░▒░░░░▒░░▒▒█▒▒▒▒▒▒▓▒▒▒░▒░▒▒▒▒▒░░░▒▒▓▒░▒▒▒░░░░░░░▒▒▒▒▒▓▒▒▒▒▒▒▒▒░░
███▓▓▓▓▓▓▓▓▓▓▓▓▓▓▓▓▓▒▒▒▒█████████████████████▓▒▓▓▓▓▓▒▒░░░░░░░░░░▒░░░░░░░▒░░░░▒▒▒▒▒▒▒▒▒▒▒▒░░░░░░░░░░░░░░░░░░▒▒▒▒▒▒▒▒▒▒▓▒▒▒▒▒░░▒▓▒▒█▒▒▒▒░░░░░░░▒▒░▒▒░░░▒▒▒▒▒▒░▒░▒░░░░░░░░▓▒▒░░▒▓▒░░░░░▒░▒░▒▒▒░░░░▒▒▒░▒▒░░░░░░░▒▒▒▒░▒▒▒▒▒▒▒▒▒░░
██▓▓▓▓▓▓▓▓▓▓▓▓▓▓▓▓▓▒▒▒▒▒█████████▓▓▓█████▓▒▓▓▓▒▓▓▒▒░░░░░░░░░░░░▒▒▒▒░░░░░▒░░░░░░░░░░░░░░▒▒▒░░░░░░░░░░░░░░░░░░░▒▒▒▒▒▒▒▒▒▒▒▒▒▒░░▒▒▒▒█▓▒▒░░░▒▒▒▒▒▒▒▒▒▒▒░░▒▒░▒▒░░░▒░░░░░░░░░▒▓▒░░▒▒▒░░░░░░░░░░▒▒░░░░▒▒▒░░▒▒░░░░░░▒▒░░░▒▒▒░░░░░░░░
██▓▓▓▓▓▓▓▓▓▓▓▓▓▓▓▓▓▒▒▒▒▒████▓▓▓████████████▒▓▓▒▒░░░░░░░░░░▒▒▒▒▒▒░░░░░░░▒▒░░░░▒░░▒▒▒▒▒░░▒░░░░░░░▒▒▒▒▒▒▒▒▒░░░░░░░░░▒▒▒▓▒▒▒▒░░░░▒▒▒▒▓▓░░▒▒▒▒▒▒▒▓▓▒▒▒▒▒▒▒▒░░▒▒░░░░░░░░░░░░░░▒▒░░░▒▒░░░░░░░░░░▒▒░░░░▒▒▒░░▒▒░░░░░░▒▒░░░▒▒░░░░░░░░░