░░░░░░░░░░░░░░░░░░░░░░░░░░░░░░░░░░░▒▒▒▓░▒▓▒▒▒▒▒▒▒▓▓▓▓▓▓▒▒▒▒▒▓▓▒▒▒▓▓▓▓▒▒▓▓█▓▓▓▒▒▒▒▒▒▒▒▒▒▒▒▒▒▒▒▒▒▒▒▒▒▒▒▒▒▒▒▒▒▒▒▒▒▒▒▒▒▒▒▒▒▒▒▒▒▒▒▒▒▒▒▒▒▒▒▒▒▒▒▒▒▒▒▒▒▒▒▒▒▒▒▒▒▒▒▒▒▒▒▒▒▒▒▒▒▒▒▒▒▒▒▒▒▒▒▒▒▒▒▒▒▒▒▒▒▒▒▒▒▒▒▒▒▒▒▒▒▒▒▒▒▒▒▒▒▒▒▒▒▒▒▒▒▒▒▒▒▒▒▒▒▒▒▒▒▒▒▓▓▓█▓▓▒▒▒▓▓▓▒▒▒▒▒▒▓▒▒▒▒▒▒▓▒▓▒▓▒▒▒▓▓▒▒▒▒▒▒▒▒▒▓▒▒▒░░▒▒░▒▒▒░▒░░▒░░░░░░░░░
░░░░░░░░░░░░░░░░░░░░░░░░░░░░░░░░░░░▒▒▒▓░▒▓▒▒▒▒▒▒▒▒▒▓▓▓▓▓▓▒▒▒▒▒▒▓▒▒▒▓▓▓▓▒▒▓██▓▓▒▒▒▒▒▒▒▒▒▒▒▒▒▒▒▒▒▒▒▒▒▒▒▒▒▒▒▒▒▒▒▒▒▒▒▒▒▒▒▒▒▒▒▒▒▒▒▒▒▒▒▒▒▒▒▒▒▒▒▒▒▒▒▒▒▒▒▒▒▒▒▒▒▒▒▒▒▒▒▒▒▒▒▒▒▒▒▒▒▒▒▒▒▒▒▒▒▒▒▒▒▒▒▒▒▒▒▒▒▒▒▒▒▒▒▒▒▒▒▒▒▒▒▒▒▒▒▒▒▒▒▒▒▒▒▒▒▒▒▒▒▒▒▒▒▓▓▓█▓▓▒▒▒▓▓▓▒▒▒▒▒▓▓▒▒▒▒▒▒▒▒▓▒▓▒▓▒▒▒▓▓▒▒▒▒▒▒▒▒▓▒▒▒▒▒▒░░░░░▒░▒░░▒░░░░░░░░░
░░░░░░░░░░░░░░░░░░░░░░░░░░░░░░░░░░░▒▒▒▓░▒▓▒░░▒▒▒▒▒▒▒▒▓▓▓▓▓▓▒▒▒▒▒▓▓▒▒▒▒▓▓▒▒▒▓█▓▓▓▒▒▒▒▒▒▒▒▒▒▒▒▒▒▒▒▒▒▒▒▒▒▒▒▒▒▒▒▒▒▒▒▒▒▒▒▒▒▒▒▒▒▒▒▒▒▒▒▒▒▒▒▒▒▒▒▒▒▒▒▒▒▒▒▒▒▒▒▒▒▒▒▒▒▒▒▒▒▒▒▒▒▒▒▒▒▒▒▒▒▒▒▒▒▒▒▒▒▒▒▒▒▒▒▒▒▒▒▒▒▒▒▒▒▒▒▒▒▒▒▒▒▒▒▒▒▒▒▒▒▒▒▒▒▒▒▒▒▒▒▒▓▓▓█▓▓▒▒▒▓▓▓▒▒▒▒▒▓▓▒▒▒▒▒▒▓▓▓▒▓▒▓▒▓▒▒▒▓▓▒▒▒▒▒▒▒░▒▒▒▒░░░░░░░▒▒░▒░░▒░░░░░░░░░
░░░░░░░░░░░░░░░░░░░░░░░░░░░░░░░░░░░▒▒▒▓░▒▓▒░░░░▒▒▒▒▒▒▒▒▒▓▒▓▓▓▒▒▒▒▒▓▓▒▒▒▓▓▓▒▒▓▓█▓▓▒▒▒▒▒▒▒▒▒▒▒▒▒▒▒▒▒▒▒▒▒▒▒▒▒▒▒▒▒▒▒▒▒▒▒▒▒▒▒▒▒▒▒▒▒▒▒▒▒▒▒▒▒▒▒▒▒▒▒▒▒▒▒▒▒▒▒▒▒▒▒▒▒▒▒▒▒▒▒▒▒▒▒▒▒▒▒▒▒▒▒▒▒▒▒▒▒▒▒▒▒▒▒▒▒▒▒▒▒▒▒▒▒▒▒▒▒▒▒▒▒▒▒▒▒▒▒▒▒▒▒▒▒▒▒▒▒▒▒▓▓██▓▒▒▒▓▓▓▒▒▒▒▒▓▓▒▒▒▒▒▒▓▓▓▒▒▒▓▒▓▒▓▒▒▒▓▓▒▒▒▒▒▒░░▒▒░▒░░░░░░░░▒░▒░░▒░░░░░░░░░
░░░░░░░░░░░░░░░░░░░░░░░░░░░░░░░░░░░▒▒▒▓░▒▓▒░░░░░░▒▒▒▒▒▒▒▒▒▓▒▓▓▓▒▒▒▒▒▒▓▒▒▒▓▓▒▒▒▓▓█▓▓▒▒▒▒▒▒▒▒▒▒▒▒▒▒▒▒▒▒▒▒▒▒▒▒▒▒▒▒▒▒▒▒▒▒▒▒▒▒▒▒▒▒▒▒▒▒▒▒▒▒▒▒▒▒▒▒▒▒▒▒▒▒▒▒▒▒▒▒▒▒▒▒▒▒▒▒▒▒▒▒▒▒▒▒▒▒▒▒▒▒▒▒▒▒▒▒▒▒▒▒▒▒▒▒▒▒▒▒▒▒▒▒▒▒▒▒▒▒▒▒▒▒▒▒▒▒▒▒▒▒▒▒▒▒▒▓▓██▓▒▒▒▓█▓▒▒▒▒▒▓▒▒▒▒▒▒▒▓▓▓▓▓▒▓▒▓▒▓▒▓▒▒▒▓▓▒▒▒▒▒░░░▒▒░▒░░░░░░░▒▒░▒░░▒░░░░░░░░░
░░░░░░░░░░░░░░░░░░░░░░░░░░░░░░░░░░░▒▒▒▓░▒▓▒░░░░░░░▒▒▒▒▒▒▒▒▒▒▓▓▓▓▓▒▒▒▒▒▓▓▒▒▓▓▓▒▒▒▓█▓▓▓▒▒▒▒▒▒▒▒▒▒▒▒▒▒▒▒▒▒▒▒▒▒▒▒▒▒▒▒▒▒▒▒▒▒▒▒▒▒▒▒▒▒▒▒▒▒▒▒▒▒▒▒▒▒▒▒▒▒▒▒▒▒▒▒▒▒▒▒▒▒▒▒▒▒▒▒▒▒▒▒▒▒▒▒▒▒▒▒▒▒▒▒▒▒▒▒▒▒▒▒▒▒▒▒▒▒▒▒▒▒▒▒▒▒▒▒▒▒▒▒▒▒▒▒▒▒▒▒▒▒▒▓▓▓█▓▒▒▒▓█▓▒▒▒▒▒▓▒▒▒▒▒▒▓▓▓▓▓▓▓▓▒▓▒▓▒▓▒▓▒▒▒▓▓▒▒▒▒░░░░▒▒░▒░░░░░░░▒▒░▒░░▒░░░░░░░░░
░░░░░░░░░░░░░░░░░░░░░░░░░░░░░░░░░░░▒▒▒▓░▒▓▒░░░░░░░░░▒▒▒▒▒▒▒▒▒▒▓▓▓▓▓▒▒▒▒▒▓▓▒▒▓▓▓▒▒▒▓█▓▓▒▒▒▒▒▒▒▒▒▒▒▒▒▒▒▒▒▒▒▒▒▒▒▒▒▒▒▒▒▒▒▒▒▒▒▒▒▒▒▒▒▒▒▒▒▒▒▒▒▒▒▒▒▒▒▒▒▒▒▒▒▒▒▒▒▒▒▒▒▒▒▒▒▒▒▒▒▒▒▒▒▒▒▒▒▒▒▒▒▒▒▒▒▒▒▒▒▒▒▒▒▒▒▒▒▒▒▒▒▒▒▒▒▒▒▒▒▒▒▒▒▒▒▒▒▒▒▒▓▓▓█▓▒▒▒▓▓▓▒▒▒▒▒▓▒▒▒▒▒▒▓▓▓▓▓▓▒▒▒▓▒▓▒▓▒▓▒▓▒▒▒▓▓▒▒▒░░░░░▒▒░▒░░░░░░░▒▒░▒░░▒░░░░░░░░░
░░░░░░░░░░░░░░░░░░░░░░░░░░░░░░░░░░░▒▒▒▓░▒▓▒░░░░░░░░░▒░▒▒▒▒▒▒▒▒▒▒▓▓▓▓▓▒▒▒▒▒▓▓▒▒▓▓▓▒▒▓██▓▓▓▓▓▓▓▓▓▓▓▓▓▓▓▓▓▓▓▓▓▓▓▓▓▓▓▓▓▓▓▓▓▓▓▓▓▓▓▓▓▓▓▓▓▓▓▓▓▓▓▓▓▓▓▓▓▓▓▓▓▓▓▓▓▓▓▓▓▓▓▓▓▓▓▓▓▓▓▓▓▓▓▓▓▓▓▓▓▓▓▓▓▓▓▓▓▓▓▓▓▓▓▓▓▓▓▓▓▓▓▓▓▓▓▓▓▓▓▓▓▓▓▓▓▓▓▓▓█▓▓▒▒▓▓▓▒▒▒▒▒▓▒▒▒▒▒▒▓▓▓▓▓▓▒▒▒▒▒▓▒▓▒▓▒▓▒▓▒▒▒▓▓▒▒░░░░░░▒▒░▒░░░░░░░▒░░▒░░▒░░░░░░░░░
░░░░░░░░░░░░░░░░░░░░░░░░░░░░░░░░░░░▒▒▒▓░▒▓▒░░░░░░░░░▒░░░▒▒▒▒▒▒▒▒▒▒▒▓▓▓▓▒▒▒▒▒▓▓▒▒▓▓▓▓▓▓▓▓▓▓▓▓▓▓▓▓▓▓▓▓▓▓▓▓▓▓▓▓▓▓▓▓▓▓▓▓▓▓▓▓▓▓▓▓▓▓▓▓▓▓▓▓▓▓▓▓▓▓▓▓▓▓▓▓▓▓▓▓▓▓▓▓▓▓▓▓▓▓▓▓▓▓▓▓▓▓▓▓▓▓▓▓▓▓▓▓▓▓▓▓▓▓▓▓▓▓▓▓▓▓▓▓▓▓▓▓▓▓▓▓▓▓▓▓▓▓▓▓▓▓▓▓▓▓█▓▒▒▓█▓▒▒▒▒▒▓▒▒▒▒▒▒▓▓▓▓▓▒▒▒▒▒▒▒▒▓▒▓▒▓▒▓▒▓▒▒▒▓▓░░░░░░░░▒▒░▒░░░░░░░▒▒░▒░░▒░░░░░░░░░
░░░░░░░░░░░░░░░░░░░░░░░░░░░░░░░░░░░▒▒▒▓░▒▓▓▓░░░░░░░░▒░░░░▒▒▒▒▒▒▒▒▒▒▒▒▓▓▓▓▓▒▒▒▒▓▓▒▒▓▓█▓▓▓▓▓▒▒▒▒▒▒▒▒▒▒▒▒▒▒▒▓▒▒▓▒▒▒▒▒▒▒▒▒▒▒▒▒▒▒▒▒▒▒▒▒▒▒▒▒▒▒▒▒▒▒▒▒▒▒▒▒▒▒▒▒▒▒▒▒▒▒▒▒▒▒▒▒▒▒▒▒▒▒▒▒▓▓▓▒▒▒▒▒▒▒▒▒▒▒▒▒▒▒▒▒▒▒▒▒▒▒▒▒▒▒▒▒▒▒▒▒▒▒▒▒▓▓▓▓▓▓▓▓▓▒▒▒▒▒▓▒▒▒▒▒▓▓▓▓▓▓▒▒▒▒▒▒▒▒▒▒▓▒▓▒▓▒▓▒▓▒▒▒▓▒░░░░░░░░▒▒░▒░░░░░░░▒▒▒▒░░▒░░░░░░░░░
░░░░░░░░░░░░░░░░░░░░░░░░░░░░░░░░░░░▒▒▒▓░▒▓▒▒▒▓▓░░░░░▒░░░░░░▒▒▒▒▒▒▒▒▒▒▒▒▓▓▓▓▓▒▒▒▒▓▓▒▓▓▓▓▓▓▓▓▓▓▓▓▓▓▓▓▓▓▓▓▓▓▓▓▓▓▓▓▓▓▓▓▓▓▓▓▓▓▓▓▓▓▓▓▓▓▓▓▓▓▓▓▓▓▓▓▓▓▓▓▓▓▓▓▓▓▓▓▓▓▓▓▓▓▓▓▓▓▓▓▓▓▓▓▓▓▓▓▓▓▓▓▓▓▓▓▓▓▓▓▓▓▓▓▓▓▓▓▓▓▓▓▓▓▓▓▓▓▓▓▓▓▓▓▓▓▓▓▓▓▓▓█▓▒▒▒▒▓▓▒▒▒▒▒▓▓▓▓▓▒▒▒▒▒▒▒▒▒▒▒▒▒▓▒▓▒▓▒▓▒▓▒▒▒▓▒░░░░░░░░▒▒░▒░░░░░▒▒▒▒░▒░░▒░░░░░░░░░
░░░░░░░░░░░░░░░░░░░░░░░░░░░░░░░░░░░▒▒▒▓░▒▓▒▒░▒▒▒▓▒░░░░░░░░░░░▒▒▒▒▒▒▒▒▒▒▒▒▓▓▓▓▓▒▒▒▒▓▓▓▒▒▒▒▒▒▒▒▒▒▒▒▒▒▒▒▒▒▒▒▒▒▒▒▒▒▒▒▒▒▒▒▒▒▒▒▒▒▒▒▒▒▒▒▒▒▒▒▒▒▒▒▒▒▒▒▒▒▒▒▒▒▒▒▒▒▒▒▒▒▒▒▒▒▒▒▒▒▒▒▒▒▒▒▒▒▒▒▒▒▒▒▒▒▒▒▒▒▒▒▒▒▒▒▒▒▒▒▒▒▒▒▒▒▒▒▒▒▒▒▒▒▒▒▒▒▒▒▒▓▓▒▒▒▓▓▒▒▒▒▓▓▓▓▓▓▒▒▒▒▒▒▒▒▒▒▒▒▒▒▒▓▒▓▒▓▒▓▒▓▒▒▒▓▒░░░░░░░░▒▒░▒░▒▒▒░░░▒░░▒░░▒░░░░░░░░░
░░░░░░░░░░░░░░░░░░░░░░░░░░░░░░░░░░░▒▒▒▓░▒▓▒▒░░▒█▒▒▒▓▒░░░░░░░░░▒▒▒▒▒▒▒▒▒▒▒▒▒▓▓▓▓▓▒▒▒▓▓▒▒▓▓▓▓▓▓▓▓▓▓▓▓▓▓▓▓▓▓▓▓▓▓▓▓▓▓▓▓▓▓▓▓▓▓▓▓▓▓▓▓▓▓▓▓▓▓▓▓▓▓▓▓▓▓▓▓▓▓▓▓▓▓▓▓▓▓▓▓▓▓▓▓▓▓▓▓▓▓▓▓▒▓▓▓▒▒▒▒▒▓▓▓▓▓▓▓▓▓▓▓▓▓▓▓▓▓▓▓▓▓▓▓▓▓▓▓▓▓▓▓▓▓▓▓▓▒▒▓▓▒▓▓▒▒▒▒▓▓▓▓▓▓▒▒▒▒▒▒▒▒▒▒▒▒▒▒▒▒▒▓▒▓▒▓▒▓▒▓▒▒▒▒▒░░░░░░░░▒▒▒▒░░░░░░░▒▒░▒░░▒░░░░░░░░░
░░░░░░░░░░░░░░░░░░░░░░░░░░░░░░░░░░░▒▒▒▓░▒▓▒▒░░▒▓▓▒▓▒▒▓▓▒░░░░░░░░▒▒▒▒▒▒▒▒▒▒▒▒▒▒▓▓▒▒▒▓▓▒▓▓▓▓▒▒▒▒▒▒▒▒▒▒▒▒▒▒▒▒▒▒▒▒▒▒▒▒▒▒▒▒▒▒▒▒▒▒▒▒▒▒▒▒▒▒▒▒▒▒▒▒▒▒▒▒▒▒▒▒▒▒▒▒▒▒▒▒▒▒▒▒▒▒▒▒▒▒▒▒▒▒▓▓▓▒▒▒▒▓▓▓▒▒▒▒▒▒▒▒▒▒▒▒▒▒▒▒▒▒▒▒▒▒▒▒▒▒▒▒▒▒▒▓▓▓▒▒▓▓▓▒▒▒▒▓▓▓▓▓▒▒▒▒▒▒▒▒▒▒▒▒▒▒▒▒▒▒▒▒▓▒▓▒▓▒▓▒▓▒▒▒▒▒░░░░░░░░▒▒░▒░░░░░░░▒▒░▒░░▒░░░░░░░░░
░░░░░░░░░░░░░░░░░░░░░░░░░░░░░░░░░░░▒▒▒▓░▒▓▒▒░░▒▓▓█▓▓▓▓▒▒▓▒░░░░░░░░▒▒▒▒▒▒▒▒▒▒▒▒▓▓▒▒▒▓▓▒▓▓▓▒▒▒▒▒▒▒▒▒▒▒▒▒▒▒▒▒▒▒▒▒▒▒▒▒▒▒▒▒▒▒▒▒▒▒▒▒▒▒▒▒▒▒▒▒▒▒▒▒▒▒▒▒▒▒▒▒▒▒▒▒▒▒▒▒▒▒▒▒▒▒▒▒▒▒▒▒▒▒▒▓▓▒▒▒▒▓▓▒▒▒▒▒▒▒▒▒▒▒▒▒▒▒▒▒▒▒▒▒▒▒▒▒▒▒▒▒▒▒▒▒▓▓▒▒▓▓▒▒▒▓▓▓▓▓▒▒▒▒▒▒▒▒▒▒▒▒▒▒▒▒▒▒▒▒▒▒▓▒▓▒▓▒▓▒▓▒░░▒▒░░░░░░░░▒▒░▒░░░░░░░▒▒░▒░░▒░░░░░░░░░
░░░░░░░░░░░░░░░░░░░░░░░░░░░░░░░░░░░▒▒▒▓░▒▓▒▒░░▒▓▒▒▓▓█▓▓▓▓▒▒▓▒░░░░░░▒▒▒▒▒▒▒▒▒▒▒▓▓▒▒▒▓▓▒▓▓▓▒▒▒▒▒▒▒▒▒▒▒▒▒▒▒▒▒▒▒▒▒▒▒▒▒▒▒▒▒▒▒▒▒▒▒▒▒▒▒▒▒▒▒▒▒▒▒▒▒▒▒▒▒▒▒▒▒▒▒▒▒▒▒▒▒▒▒▒▒▒▒▒▒▒▒▒▒▒▒▒▓▓▒▒▒▒▓▓▒▒▒▒▒▒▒▒▒▒▒▒▒▒▒▒▒▒▒▒▒▒▒▒▒▒▒▒▒▒▒▒▒▓▓▒▒▓▓▓▓▓▓▓▒▒▒▒▒▒▒▒▒▒▒▒▒▒▒▒▒▒▒▒▒▒▒▒▒▓▒▓▒▓▒▓▒▒░░░▒▒░░░░░░░░▒▒░▒░░░░░░░▒▒░▒░░▒░░░░░░░░░
░░░░░░░░░░░░░░░░░░░░░░░░░░░░░░░░░░░▒▒▒▓░▒▓▒▒░░▒▓▒▒▒▒▒▓▓▓▓▒▓▓▒▓▓▒░░░░▒▒▒▒▒▒▒▒▒▒▓▓▒▒▒▓▓▒▓▓▓▒▒▒▒▒▒▒▒▒▒▒▒▒▒▒▒▒▒▒▒▒▒▒▒▒▒▒▒▒▒▒▒▒▒▒▒▒▒▒▒▒▒▒▒▒▒▒▒▒▒▒▒▒▒▒▒▒▒▒▒▒▒▒▒▒▒▒▒▒▒▒▒▒▒▒▒▒▒▒▓▓▓▓▓▓▓▓▓▓▓▓▓▓▓▓▓▓▓▓▓▓▓▓▓▓▓▓▓▓▓▓▓▓▓▓▓▓▓▓▓▓▓▓▓▓▓▓▓▓▓▓▓▓▓▓▓▓▓▓▓▓▓▒▒▒▒▒▒▒▒▒▒▒▒▒▒▒▓▒▓▒▓░▓▒▒░░░▒▒░░░░░░░░▒▒░▒░░░░░░░▒▒░▒░░▒░░░░░░░░░
░░░░░░░░░░░░░░░░░░░░░░░░░░░░░░░░░░░▒▒▒▓░▒▓▒▒░░▒▓▒░░▒▒▒▒▒▓█▓▓▓▓▒▒▓▒▒░░░▒▒▒▒▒▒▒▒▓▓▒▒▒▓▓▒▓▓▓▒▒▒▒▒▒▒▒▒▒▒▒▒▒▒▒▒▒▒▒▒▒▒▒▒▒▒▒▒▒▒▒▒▒▒▒▒▒▒▒▒▒▒▒▒▒▒▒▒▒▒▒▒▒▒▒▒▒▒▒▒▒▒▒▒▒▒▒▒▒▒▒▒▒▒▒▒▒▓▓▒█▓███▓██▓█▓█████▓█▓█▓█████████▒▒░▓▓▓▓▓▓▓▓▓▓▓▓▓▓▓▓▓▓▓▓▓▓▓███▒▓▓▒▒▒▒▒▒▒▒▒▒▒▒▒▒▓▒▒▒▒░▓▒▒░░░▒▒░░░░░░░░▒▒░▒░░░░░░░▒▒░▒░░▒░░░░░░░░░
░░░░░░░░░░░░░░░░░░░░░░░░░░░░░░░░░░░▒▒▒▓░▒▓▒▒░░▒▓▒▓░░░▒▒▒▒▒▒▓█▓▓▒▓▒▒▓▒░░▒▒▒▒▒▒▒▓▓▒▒▒▓▓▒▓▓▓▒▒▒▒▒▒▒▒▒▒▒▒▒▒▒▒▒▒▒▒▒▒▒▒▒▒▒▒▒▒▒▒▒▒▒▒▒▒▒▒▒▒▒▒▒▒▒▒▒▒▒▒▒▒▒▒▒▒▒▒▒▒▒▒▒▒▒▒▒▒▒▒▒▒▒▒▒▓▓▓▒▓▒▒▒▓▓▒▒▓▒▒▒▓▒▓▓▓▓▓▒▓▓▒▒▒▒▒▓▓▓▒▒░▓▓▓▓▓▒▓▓▒▒▓▓▒▒▒▒▒▒▒▒▓▓▓▓▓▓▒▓▓▒▒▒▒▒▒▒▒▒▒▒▒▒▒▓▒▒░▒░▓▒▒░░░▒▒░░░░░░░░▒▒░▒░░░░░░░▒▒░▒░░▒░░░░░░░░░
░░░░░░░░░░░░░░░░░░░░░░░░░░░░░░░░░░░▒▒▒▓░▒▓▒▒░░▒▓▒▓▒▒▒▒░░░▒▒▒▒▓▓█▓▓▓▓▒▒▓░▒▒▒▒▒▒▓▓▒▒▒▓▓▒▓▓▓▒▒▒▒▒▒▒▒▒▒▒▒▒▒▒▒▒▒▒▒▒▒▒▒▒▒▒▒▒▒▒▒▒▒▒▒▒▒▒▒▒▒▒▒▒▒▒▒▒▒▒▒▒▒▒▒▒▒▒▒▒▒▒▒▒▒▒▒▒▒▒▒▒▒▒▒▒▓▓▓▒▓▓▓▓▓▓▓▓▓▓▓▓▓▓▓▓▓▓▓▓▓█▓▓▓▓▓▓▓▓▒▒░▓▓▓▓▓▓▓▓▓▓▓▓▓▓▓▓▓▓▓▓█▓▓▓▓▓▒▓▓▒▒▒▒▒▒▒▒▒▒▒▒▒▒▓▒▒░▒░▓▒▒░░░▒▒░░░░░░░░▒▒░▒░░░░░░░▒▒░▒░░▒░░░░░░░░░
░░░░░░░░░░░░░░░░░░░░░░░░░░░░░░░░░░░▒▒▒▓░▒▓▒▒░░▒▓▒▒░▒▓▓▒▒▒░░░▒▒▒▒▓███▓░▓░▒▒▒▒▒▒▓▓▒▒▒▓▓▒▓▓▓▒▒▒▒▒▒▒▒▒▒▒▒▒▒▒▒▒▒▒▒▒▒▒▒▒▒▒▒▒▒▒▒▒▒▒▒▒▒▒▒▒▒▒▒▒▒▒▒▒▒▒▒▒▒▒▒▒▒▒▒▒▒▒▒▒▒▒▒▒▒▒▒▒▒▒▒▒▓▒▓▒▓▒▓▓▓▓▓▓▓▓▓▓▓▓▓▓▓▓▓▓▓▓▒▓█▓▓▓▓▓▒▒░▓▓▓▓▓▓▒█▓▓▓▓▓▓▓▓▓▓▓▓▓▓▓▓▓▓▒▓▓▒▒▒▒▒▒▒▒▒▒▒▒░▒▒▒▒▒▒░▓▒▒░░░▒▒░░░░░░░░▒▒░▒░░░░░░░▒▒░▒░░▒░░░░░░░░░
░░░░░░░░░░░░░░░░░░░░░░░░░░░░░░░░░░░▒▒▒▓░▒▓▒▒░░▒▓▒▒░░▒▒▒▒▓▒▒▒▒░░▒▒▓▓▓▓░▓░▒▒▒▒▒▒▓▓▒▒▒▓▓▒▓▓▓▒▒▒▒▒▒▒▒▒▒▒▒▒▒▒▒▒▒▒▒▒▒▒▒▒▒▒▒▒▒▒▒▒▒▒▒▒▒▒▒▒▒▒▒▒▒▒▒▒▒▒▒▒▒▒▒▒▒▒▒▒▒▒▒▒▒▒▒▒▒▒▒▒▒▒▒▒▓▒▓▒▓▒▓▓▓▓▓▓▓▒▓▒▓▓▓▒▓▓▓▓▒▓▒▓▓▓▓▓▓▓▒▒░▓▓▓▒▓▓▒▓▓▓▒▓▓▓▓▓▓▓▓▓▓▓▓▒▓▓▒▓▓▓▒▒▒▒▒▒▒▒░░░░▒▒▒▒░▒░▓▒▒░░░▒▒░░░░░░░░▒▒░▒░░░░░░░▒▒░▒░░▒░░░░░░░░░
░░░░░░░░░░░░░░░░░░░░░░░░░░░░░░░░░░░▒▒▒▓░▒▓▒▒░░▒▓▒▒░░▒▒░░░░▒▓▓▒▒░▒▓▓▓▒░▓░▒▒▒▒▒▒▓▓▒▒▒▓▓▒▓▓▓▒▒▒▒▒▒▒▒▒▒▒▒▒▒▒▒▒▒▒▒▒▒▒▒▒▒▒▒▒▒▒▒▒▒▒▒▒▒▒▒▒▒▒▒▒▒▒▒▒▒▒▒▒▒▒▒▒▒▒▒▒▒▒▒▒▒▒▒▒▒▒▒▒▒▒▒▒▓▒▓▒▓▒▓▓▓▓▓▓▓▒▓▒▓▓▓▒▓▓▓▓▒▓▒▓▓▓▓▓▓▓▒▒░▓▓▓▒▓▓▒▓▓▓▒▓▓▓▓▓▓▓▓▓▓▓▓▒▒▓▒▓▓▓▒▒▒▒▒▒░░░░░░▒▒▒▒▒▒░▓▒▒░░░▒▒░░░░░░░░▒▒░▒░░░░░░░▒▒░▒░░▒░░░░░░░░░
░░░░░░░░░░░░░░░░░░░░░░░░░░░░░░░░░░░▒▒▒▓░▒▓▒▒░░▒▓▒▒░░▒▒░░░░░░░▓▒▒▒▓▒▓▒░▓▒▒▒▒▒▒▒▓▓▒▒▒▓▓▒▓▓▓▒▒▒▒▒▒▒▒▒▒▒▒▒▒▒▒▒▒▒▒▒▒▒▒▒▒▒▒▒▒▒▒▒▒▒▒▒▒▒▒▒▒▒▒▒▒▒▒▒▒▒▒▒▒▒▒▒▒▒▒▒▒▒▒▒▒▒▒▒▒▒▒▒▒▒▒▒▓▒▓▒▓░▓▒▒▓▒▒▒░▒▒▒▒▒▒▓▒▒▒▒▓░▓▓▒▒▒▓▓▒▒░▓▒▓▒▒▓▒▓▒▓▒▒▒▒▒▒▒▒▒▓█▓▒▒▒▓▒▓▓▓▒▒▒░░░░░░░▒▓▓▓▒▒░▒░▓▒▒░░░▒▒░░░░░░░░▒▒░▒░░░░░░░▒▒░▒░░▒░░░░░░░░░
░░░░░░░░░░░░░░░░░░░░░░░░░░░░░░░░░░░▒▒▒▓░▒▓▒▒░░▒▓▒▒░░▒▒░░░░░░░▒▒░▒▓▒▓▒░▓▒▒▒▒▒▒▒▓▓▒▒▒▓▓▒▓▓▓▒▒▒▒▒▒▒▒▒▒▒▒▒▒▒▒▒▓▒▒▒▒▒▒▒▒▒▒▒▒▒▒▒▒▒▒▒▒▒▒▒▒▒▒▒▒▒▒▒▒▒▒▒▒▒▒▒▒▒▒▒▒▒▒▒▒▓▒▒▒▒▒▒▒▒▒▒▓▒▓▒▓▒▒▒▒▒▒▒▒▒▒▒▒▒▒▒▒▒▒▒▒▒▒▒▒▒▒▒▒▓▒▒░▓▒▒▒▒▒▒▒▒▒▒▒▒▒▒▒▒▒▒▒▒▒▒▒▒▓▒▓▓▒▒░░░░░▒▒▓▒▓▓▓▓▒▒▒▒░▓▒▒░░░▒▒░░░░░░░░▒▒░▒░░░░░░░▒▒░▒░░▒░░░░░░░░░
░░░░░░░░░░░░░░░░░░░░░░░░░░░░░░░░░░░▒▒▒▓░▒▓▒▒░░▒▓▒▒░░▒▒░░░░░░░▒▒▒▒▓▒▓▒░▓▒▒▒▒▒▒▒▓▓▒▒▒▓▓▒▓▓▓▒▒▒▒▒▒▒▒▒▒▒▒▒▒▒▒▒▓▒▒▒▒▒▒▒▒▒▒▒▒▒▒▒▒▒▒▒▒▒▒▒░░░░░░░░░░░░░░░░░░░░▒▒▒▒▒▓▒▒▒▒▒▒▒▒▒▒▓▒▓▒▓▓▓▓▓▓▓▓▓▓▓▓▓▓▓▓▓▓▓▓▓▓▓▓▓▓▓▓▓█▒▒░▓▓▓▓▓▓▓▓▓▓▓▓▓▓▓▓▓▓▓▓▓▓▓▓▓▓░▓▓▒░░▒▒▒▓▒▒▒▒▒▒▓▓▒▒░▒░▓▒▒░░░▒▒░░░░░░░░▒▒░▒░░░░░░░▒▒░▒░░▒░░░░░░░░░
░░░░░░░░░░░░░░░░░░░░░░░░░░░░░░░░░░░▒▒▒▓░▒▓▒▒░░▒▓▒▒░░▒▒░░░░░░░▒▒░▒▓▒▓▒░▓░▒▒▒▒▒▒▓▓▒▒▒▓▓▒▓▓▓▒▒▒▒▒▒▒▒▒▒▒▒▒▒▒▒▒▓▒▒▒▒▓▓▓▓▓▓▓▓▓▓▓▓▓▓▓▒▒▒▒▒▒▒▒▒▓▒▒▒▒▒▒▒▒▒▒▒▒▓▓▒░▒▒▒▓▒░░░░░░░▒▒▓▒▓▒▓▓▓▓▓▓▓▓▓▓▓▓▓▓▓▓▓▓▓▓▓▓▓▓▓▓▓█▓▓▒▒░▓▓▓▓▓▓▓▓▓▓▓▓▓▓▓▓▓▓▓▓█▓▓▓▓▒░▓▓▒▓▒▒▒▒░░▒▒▒▒▒▓▓▒▒░▒░▓▒▒░░░▒▒░░░░░░░░▒▒░▒░░░░░░░▒▒░▒░░▒░░░░░░░░░
░░░░░░░░░░░░░░░░░░░░░░░░░░░░░░░░░░░▒▒▒▓░▒▓▒▒░░▒▓▒▒░░▒▒░░░░░░░▒▒░▒▓▒▓▒░▓▒▒▒▒▒▒▒▓▓▒▒▒▓▓▒▓▓▓▒▒▒▒▒▒▒▒▒▒▒▒▒▒▒▒▒▓▒▒▒▒▒▓▓▒▒▒▒▒▒▒▒▒▒▒▒▒▒▒▒▒▒▒▒▒▒▒▒▒▒▒▒▒▒▒▒▒▒▓▓▒░▒▒▒▓▒░░░░░░░▒▒▓▒▓▒▓▓▓▓▓▓▒▒▒▒▒▒▒▒▒▓▓▒▒▒▒▒▓▒▓▓▓▓▓▓▒▒░▓▓▓▒▒▒▒▒▓▒▓▓▒▓▓▓▓▓▓▓▓▓▓▓▓▒▒▓▓▓▒░░░▒▒░░░▒▒▒▓▓▒▒▒▒░▓▒▒░░░▒▒░░░░░░░░▒▒░▒░░░░░░░▒▒░▒░░▒░░░░░░░░░
░░░░░░░░░░░░░░░░░░░░░░░░░░░░░░░░░░░▒▒▒▓░▒▓▒▒░░▒▓▒▒░░▒▒░░░░░░░▒▒▒▒▓▒▓▒░▓░░▒▒▒▒▒▓▓▒▒▒▓▓▒▓▓▓▒▒▒▒▒▒▒▒▒▒▒▒▒▒▒▒▒▓▒▒▒▒▒▓▒▒▒▒▒▒▒▒▒▒▒▒▒▒▒▒▒▒▒▒▒▒▒▒▒▒▒▒▒▒▒▒▒▒▒▓▓▒░▒▒▒▓▒░░░░░░░▒▒▓▒▓▒▓▓▓▒▓▒▓▓▒▓▓▓▓▒▓▒▓▒▓▓▓▓▒▓▓▓▓▓▓▓▒▒░▓▓▓▓▓▓██▓▓▓▓▓▓▓▓▓▓▓▓▓▓▓▓▒▒░▓▓▒▒▒▒░░░░░░▒▒▒▓▓▒▒░▒░▓▒▒░░░▒▒░░░░░░░░▒▒░▒░░░░░░░▒▒░▒░░▒░░░░░░░░░
░░░░░░░░░░░░░░░░░░░░░░░░░░░░░░░░░░░▒▒▒▓░▒▓▒▒░░▒▓▒▒░░▒▒░░░░░░░▒▒░▒▓▒▓▒░▓▒░░▒▒▒▒▓▓▒▒▒▓▓▒▓▓▓▒▒▒▒▒▒▒▒▒▒▒▒▒▒▒▒▒▓▒▒▒▒▒▓▓▒▒▒▒▒▒▒▒▒▒▒▒▒▒▒▒▒▒▒▒▒▒▒▒▒▒▒▒▒▒▒▒▒▒▓▒▒░▒▒▒▓▒░░░░░░░▒▒▓▒▓▒▓▓▓▓▓▓▓▒▒▒▒▒▒▒▒▒▒▒▒▒▒▒▓▓█▓▓▓▓▓▒▒░▓▓▓█▓▓▒▓▓▓▓▓▓▓▓▓▓▓▓▓▓▓▓▓░▒░▓▓▒░░░░░░░░░▒▒▒▓▓▒▒▒▒░▓▒▒░░░▒▒░░░░░░░░▒▒░▒░░░░░░░▒▒░▒░░▒░░░░░░░░░
░░░░░░░░░░░░░░░░░░░░░░░░░░░░░░░░░░░▒▒▒▓░▒▓▒▒░░▒▓▒▒░░▒▒░░░░░░░▒▒░▒▓▒▓▒░▓░░░░▒▒▒▓▓▒▒▒▓▓▒▓▓▓▒▒▒▒▒▒▒▒▒▒▒▒▒▒▒▒▒▓▒▒▒▒▒▓▓▒▒▒▒▓▓▓▓▓▓▓▓▓▓▓▓▓▓▓▓▓▓▓▓▓▓▓▓▓▒▒▒▒▒▓▒▒░▒▒▒▓▒░░░░░░░▒▒▓▒▓▒▓▒▓▓▒▒▓▓▓▓▓▓▓▒▒▒▒▒▒▒▒▓▒░░░▒▓▓▓▒▒░▓▓▓▓▓▓▒▓▓▒▓▓▓▓▓▒▓▒▒▓▒▓▓▒░▒░▓▓▒░░░░░░░░░▒▒▒▓▓▒▒░▒░▓▒▒░░░▒▒░░░░░░░░▒▒░▒░░░░░░░▒▒░▒░░▒░░░░░░░░░
░░░░░░░░░░░░░░░░░░░░░░░░░░░░░░░░░░░▒▒▒▓░▒▓▒▒░░▒▓▒▒░░▒▒░░░░░░░▒▒▒▒▓▒▓▒░▓░░░░▒▒▒▓▓▒▒▒▓▓▒▓▓▓▒▒▒▒▒▒▒▒▒▒▒▒▒▒░░░▓▒▒▒▒▒▓▓▒▒▒▒▒▒▓▒▒▒▒▒▒▒▒▒▒▒▒▒▒▒▒▒▒▒▒▓▒░░░░▒▓▒▒░▒▒▒▓▒░░░░░░░▒▒▓▒▓▒▓▒▒▒▒▒▓▓▓▓▓▓▓▒▒▒▒▒▒▒▒▓░▒░▒░▓▓▓▒▒░▓▓▒▒▒▓░▓▒▒▒▒▒▒▓▒▓▒▓▒▓▓▓▒░▒▒▓▓▒░░░░░░░░░▒▒▒▓▓▒▒▒▒░▓▒▒░░░▒▒░░░░░░░░▒▒░▒░░░░░░░▒▒░▒░░▒░░░░░░░░░
░░░░░░░░░░░░░░░░░░░░░░░░░░░░░░░░░░░▒▒▒▓░▒▓▒▒░░▒▓▒▒░░▒▒░░░░░░░▒▒▒▒▓▒▓▒░▓░░░░░▒▒▓▓▒▒▒▓▓▒▓▓▓▒▒▒▒▒▒▒▒▒▒░░░░░░░▓▒▒▒▒▒▓▓▒▒░░▒▒▓▒▒░░░░░░░░▒░░░░░░░░░▓▒░░░░▒▓▒▒░▒▒▒▓▒░░░░░░░▒▒▓▒▓▒▓▒▓▒▒▒▓▓▒▒▒▒▒▒▒▒▒▓▒▒▒▓░░▒░▒▓▓▓▒▒░▓▓▒▒▒▓░▓▒▒▒▒▒▒▓▒▓▒▓▒█▓▓▒░▒▒▓▓▒░░░░░░░░░▒▒▒▓▓▒▒░▒░▓▒▒░░░▒▒░░░░░░░░▒▒░▒░░░░░░░▒▒░▒░░▒░░░░░░░░░
░░░░░░░░░░░░░░░░░░░░░░░░░░░░░░░░░░░▒▒▒▓░▒▓▒▒░░▒▓▒▒░░▒▒░░░░░░░▒▒░▒▓▒▓▒░▓░░░░░▒░▓▓▒▒▒▓▓▒▓▓▓▒▒▒▒▒▒░░░░░░░░░░░▓▒▒▒▒▒▓▒░░░░▒▒▓░░░░░░░░░░▒░░░░░░░░░▓▒░░░░▒▓▒▒░▒▒▒▓▒░░░░░░░▒▒▓▒▓▒▓░▓▒▒▒▓▒▒▒▓▒▒▒▒▒▓░░░▒▓▓▒▒▒█▓▓▓▒▒░▓▓▒▒▒▓░▓▒▒▒▒▒▒▓▒▓▓▒▒▓▓▓░░▒░▓▓▒░░░░░░░░░▒▒▒▓▓▒▒░▒░▓▒▒░░░▒▒░░░░░░░░▒▒░▒░░░░░░░▒▒░▒░░▒░░░░░░░░░
░░░░░░░░░░░░░░░░░░░░░░░░░░░░░░░░░░░▒▒▒▓░▒▓▒▒░░▒▓▒▒░░▒▒░░░░░░░▒▒░▒▓▒▓▒░▓░░░░░░░▒▒▒▒▒▓▓▒▓▓▓▒▒░░░░░░░░░░░░░░░▓▒▒▒▒▒▓▒▒░░░▒▒▓░░░░░░░░░░▒░░░░░░░░░▓▒░░░░▒▓▒▒░▒▒▒▓▒░░░░░░░▒▒▓▒▓▒▓▒▒▒▒▒▒▒▒▒▒▒▒▒▒▒▒▒▒▒▒▒▒▒▒▒▒▒▒▓▒▒░▓▒▒▒▒▒▒▒▒▒▒▒▒▒▒▒▒▒▒▒▒▒▒▒▒▓▒▓▓▒░░░░░░░░░▒▒▒▓▓▒▒░▒░▓▒▒░░░▒▒░░░░░░░░▒▒░▒░░░░░░░▒▒░▒░░▒░░░░░░░░░
░░░░░░░░░░░░░░░░░░░░░░░░░░░░░░░░░░░▒▒▒▓░▒▓▒▒░░▒▓▒▒░░▒▒░░░░░░░▒▒░▒▓▒▓▒░▓░░░░░▒░▒▒▒▒▒▓▓▒▒▒▒░░░░░░░░░░░░░░░░░▓▒▒▒▒▒▓▒░░░░░▒▓░░░░░░░░░░▒░░░░░░░░░▒▒░░░░▒▓▒▒▒▒▒▒▓▒░░░░░░░▒▒▓▒▓▒▓▓▓▓▓▓▓▓▓▓▓▓▓▓▓▓▓▓▓▓▓▓▓▓▓▓▓▓▓█▒▒░▓▓▓▓▓▓▓▓▓▓▓▓▓▓▓▓▓▓▓▓▓▓▓██▓▒▓▓▒░░░░░░░░░▒▒▒▓▓▒▒▒▒░▓▒▒░░░▒▒░░░░░░░░▒▒░▒░░░░░░░▒▒░▒░░▒░░░░░░░░░
░░░░░░░░░░░░░░░░░░░░░░░░░░░░░░░░░░░▒▒▒▓░▒▓▒▒░░▒▓▒▒░░▒▒░░░░░░░▒▒▒▒▓▒▓▒░▓░░░░░▒░▒▒▒░▒▓▒░▒▒▒░░░░░░░░░░░░░░░░░▓▒▒▒▒▒▓▒▒░░░▒▒▓░░░░░░░░░░▒░░░░░░░░░▓▒░░░░▒▓▒▒░▒▒▒▓▒░░░░░░░▒▒▓▒▓▒█▓▓▓▓▓▓▓▓▓▓▓▓▓▓▓▓▓▓▓▓▓▓▓▓▓█▓▓▓▒▒░▓▓▓▓▓▓▓▓▓▓▓▓▓█▓▓▓▓▓██▓▓▓▓▒▒▓█▒░░░░░░░░░▒▒▒▓▓▒▒░▒░▓▒▒░░░▒▒░░░░░░░░▒▒░▒░░░░░░░▒▒░▒░░▒░░░░░░░░░
░░░░░░░░░░░░░░░░░░░░░░░░░░░░░░░░░░░▒▒▒▓░▒▓▒▒░░▒▓▒▒░░▒▒░░░░░░░▒▒▒▒▓▒▓▒░▓░░░░░▒░▒▒▒░▒▓▒░▒▒▒░░░░░░░░░░░░░░░░░▓▒▒▒▒▒▓▒░░░░▒▒▓░░░░░░░░░░▒░░░░░░░░░▒▒░░░░▒▓▒▒░▒▒▒▓▒░░░░░░░▒▒▓▒▓▒▓▓▓▓▓▓▓▓▓▓▓▓▓▓▒▓▓▓▓▓▒▓▓█▓▓▓▓▓▓▒▒░▓█▓▓▓▓▓█▓▓▓▓▓█▓▓▓▓▓▓█▓▒▒▒░░▒▒▒░░░░░░░░░▒▒▒▓▓▒▒▒▒░▓▒▒░░░▒▒░░░░░░░░▒▒░▒░░░░░░░▒▒░▒░░▒░░░░░▒▒▒▒
░░░░░░░░░░░░░░░░░░░░░░░░░░░░░░░░░░░▒▒▒▓░▒▓▒▒░░▒▓▒▒░░▒▒░░░░░░░▒▒░▒▓▒▓▒░▓░░░░░▒░▒▒▒░▒▓▒░▒▒▒░░░░░░░░░░░░░░░░░▓▒▒▒▒▒▓▒░░░░▒▒▓░░░░░░░░░░▒░░░░░░░░░▒▒░░░░▒▓▒▒░▒▒▒▓▒░░░░░░░▒▒▓▒▓▒▓▒▓▓▓▓▓▒▓▒▓▓▓▓▒▓▓▓▓▓▓▓▓█▓▓▓▓▓▓▒▒░▓█▓▓▓▓▓▓▒▓▒▓▓█▓▓▓▓▓▓▓▒▒░▒░▒▒▒▓░░░▒▒▒▒▒▒▒▒▒▓▓▒▒░▒░▓▒▒░░░▒▒░░░░░░░░▒▒░▒░░░░░▒▒▒▒▒▒▒▒▒▒░░▒▒▒▒▒▒
░░░░░░░░░░░░░░░░░░░░░░░░░░░░░░░░░░░▒▒▒▓░▒▓▒▒░░▒▓▒▒▒▒▒▒░░░░░░░▒▒▒▒▓▒▓▒░▓░░░░░▒░▒▒▒░▒▓▒░▒▒▒░░░░░░░░░░░░░░░░░▓▒▒▒▒▒▓▒▒░░░░▒▓░░░░░░░░░░▒░░░░░░░░░▒▒░░░░▒▓▒▒░▒▒▒▓▒░░░░░░░▒▒▓▒▓▒▓░▓▓▒▓▓▒▓▒▓▓▒▓▒▓▓▒▒▓▓▒▓▓▒▓▓▓▓▓▒▒░▒▓▓▒▒▒▒▓▒▓▒▓▒▓▓▒▒▒▒▓▓▒▒░▒░▒░▒▒▓▒░▒▒▒▒▒▓▓▓▓▓▓▒▒▒▒░▓▒▒░░░▒▒░░░░░░░░▒▒▒▒▒▒░▒▒▒▒▒▒▒▒▒▒▒░░░░░░░░░
░░░░░░░░░░░░░░░░░░░░░░░░░░░░░░░░░░░▒▒▒▓░▒▓▒▒░░▒▓▒▓▓▒▒▒▒▒▒▒▒▒▒▒▒▒▒▓▒▓▒░▓░░░░░▒░▒▒▒░▒▓▒░▒▒▒░░░░░░░░░░░░░░░░░▓▒▒▒▒▒▓▒░░░░▒▒▓░░░░░░░░░░▒░░░░░░░░░▓▒░░░░▒▓▒▒░▒▒▒▓▒░░░░░░░▒▒▓▒▓▒▓░▓▓▒▒▒░▒▒▒▒▒▓▒▓▓░▒▓▓▒▓▓▒▓▓▓▓▓▒▒░▒▓▒▒▒▒▒▓░▓▒▓▒▓▒▒▒▒▒▓▒▒░▒▒▒▒▒▒▒▒▓▓█▓▓▒░░░░░▒▒▒▒░▒░▓▒▒░░░▒▒░░░░░░░░▒▒▒▒░░░░░░░▒▒▒▒▒▒▓▒▒▓▓▓▓▓▓▒
░░░░░░░░░░░░░░░░░░░░░░░░░░░░░░░░░░░▒▒▒▓░▒▓▒▒░░▒▓▒░░░▒▒░░▒░▒▒▓▓▓▒▒▓▒▓▒░▓░░░░░▒░▒▒▒░▒▓▒░▒▒▒░░░░░░░░░░░░░░░░░▓▒▒▒▒▒▓▒░░░░▒▒▓░░░░░░░░░░▒░░░░░░░░░▒▒░░░░▒▓▒▒░▒▒▒▓▒░░░░░░░▒▒▓▒▓▒▓░▓▓▒▒▒░▒▒▒▒▒▓░▓▓░▒▓▒▒▒▓░▓▓▓▓▓▒▒░▒▓▒▒▒▒▒▓░▓░▓▒▓▒▒▒▒▓▓▒▒▓▒▓▓▓▓▓▓▓▓░░░░░░░░░░▒▒▒▒░▒░▓▒▒░░░▒▒░░░░░░░░▓▒▒▓▓▓██▓▓▒▒▒▒▒░░░░░░░░░░░░
░░░░░░░░░░░░░░░░░░░░░░░░░░░░░░░░░░░▒▒▒▓░▒▓▒▒░░▒▓▒▒░░▒▒░░░░░░░░▒░▒▓▒▓▒░▓░░░░░▒░▒▒▒░▒▓▒░▒▒▒░░░░░░░░░░░░░░░░░▓▒▒▒▒▒▓▒░░░░▒▒▓░░░░░░░░░░▒░░░░░░░░░▓▒░░░░▒▓▒▒░▒▒▒▓▒░░░░░░░▒▒▓▒▓▒▓▒▒▒▒▒▒▒▒▒▒▒▒▓▒▓▓▒▒▒▒▓▒▒▒▒▒▓▒▓▒▒░▓▓▒▒▒▒▒▓▒▓▒▓▒▓▒▒▒▒▒▓▓▓▓▓▓█▓▓▓░░░░░░░░░░░░░▒▒▒▒░▒░▓▒▒░░░▒▒░░░░░░░░░░░░░░░░░░░░░░▒░░░░░░░░░░░░
░░░░░░░░░░░░░░░░░░░░░░░░░░░░░░░░░░░▒▒▒▓░▒▓▒▒░░▒▓▒▒░░▒▒░░░░░░░░▒░▒▓▒▒▒░▓░░░░░▒░▒▒▒░▒▓▒░▒▒▒░░░░░░░░░░░░░░░░░▓▒▒▒▒▒▓▒▒░░░░▒▓░░░░░░░░░░▒░░░░░░░░░▓▒░░░░▒▓▒▒░▒▒▒▓▒░░░░░░░▒▒▓▒▓▒██████████████▓███████████████▒▒░▓████████████████████████▓▓▓▓░▒▒▒▒░░░░░░░░▒▒▒▒░▒░▓▒▒░░░▒▒░░░░░░░░░░░░░░░░░░░░░░▒░░░░░░░░░░░░
░░░░░░░░░░░░░░░░░░░░░░░░░░░░░░░░░░░▒▒▒▓░▒▓▒▒░░▒▓▒▒░░▒▒░░░░░░░░▒░▒▓▒▓▒░▓░░░░░▒░▒▒▒░▒▓▒░▒▒▒░░░░░░░░░░░░░░░░░▓▒▒▒▒▒▓▒░░░░▒▒▓░░░░░░░░░░▒░░░░░░░░░▒▒░░░░▒▓▒▒░▒▒▒▓▒░░░░░░░▒▒▓▒▓▒▓▓▓▓▓▓▓▓▓▓▓▓▓▓▓▓▓▓▓▓▓▓▓▓▓▓▓▓▓▓▒▒░▓█▓▓▓▓▓▓▓▓▓▓▓█▓▓▓▓▓▓▓▓▓▓▓▒▓▓▓▒▒▒▒▒░░░░░░░░▒▒▒▒░▒░▓▒▒░░░▒▒░░░░░░░░░░░░░░░░░░░░░░▒░░░░░░░░░░░░
░░░░░░░░░░░░░░░░░░░░░░░░░░░░░░░░░░░▒▒▒▓░▒▓░▒░░▒▓▒▒░░▒▒░░░░░░░░▒░▒▓▒▓▒░▓░░░░░▒░▒▒▒░▒▓▒░▒▒▒░░░░░░░░░░░░░░░░░▓▒▒▒▒▒▓▒▒░░░▒▒▓░░░░░░░░░░▒░░░░░░░░░▓▒░░░░▒▓▒▒░▒▒▒▓▒░░░░░░░▒▒▓▒▓▒▓▓▓▓▓▓▓▓▓▓▓▓▓▓▒▓▒▓▒▓▓▓▓▓▒▓▓▓▓▓▒▒░▓▓▓▓▓▓▓▓▒▓▒▓▓▓▓▓▓▓▓▓▓▓▓▓▓▒▓▓▓▒▒▒▒▒▒░░░░░░░▒▒▒▒░▒░▓▒▒░░░▒▒░░░░░░░░░░░░░░░░░░░░░░▒░░░░░░░░░░░░
░░░░░░░░░░░░░░░░░░░░░░░░░░░░░░░░░░░▒▒▒▓░▒▓░▒░░▒▓▒▒░░▒▒░░░░░░░░▒░▒▓▒▓▒░▓░░░░░░░▒▒▒░▒▓▒░▒▒▒░░░░░░░░░░░░░░░░░▓▒▒▒▒▒▓▒░░░░▒▒▓░░░░░░░░░░▒░░░░░░░░░▓▒░░░░▒▓▒▒░▒▒▒▓▒░░░░░░░▒▒▓▒▓▒▓▓▒▓▒▓▓▒▓▒▒▒▒▓▒▓▒▓▒▒▒▒▒▓▒▒▓▓▓▓▒▒░▓▓▓▓▓▓▓▓▒▓▒▓▓▓▓▓▒▒▒▓▓▓▓▓▓▒▓▓▓▒▒▒▒▒▒░░░░░░░▒▒▒▒░▒░▓▒▒░░░▒▒░░░░░░░░░░░░░░░░░░░░░░▒░░░░░░░░░░░░
░░░░░░░░░░░░░░░░░░░░░░░░░░░░░░░░░░░▒▒▒▓░▒▓░▒░░▒▓▒▒░░▒▒░░░░░░░░▒▒▒▓▒▓▒░▓▒░░░░▒░▒▒▒░▒▓▒░▒▒▒░░░░░░░░░░░░░░░░░▓▒▒▒▒▒▓▒▒░░░░▒▓░░░░░░░░░░▒░░░░░░░░░▓▒░░░░▒▓▒▒░▒▒▒▓▒░░░░░░░▒▒▓▒▓▒▒▒▒▒▒▒▒▒▒▒▒▒▒▒▒▒▒▒▒▒▒▒▒▒▒▒▒▒▒▓▒▒░▓▒▒▒▒▒▒▒▒▒▒▒▒▒▒▒▒▒▒▒▒▒▒▓▓▒▓▓▓▒▒▒▒▒▒▒░░░░░░▒▒▒▒░▒░▓▒▒░░░▒▒░░░░░░░░░░░░░░░░░░░░░░▒░░░░░░░░░░░░
░░░░░░░░░░░░░░░░░░░░░░░░░░░░░░░░░░░▒▒▒▓░▒▓░▒░░▒▓▒▒░░▒▒░░░░░░░░▒░▒▓▒▒▒░▓▒░░░░▒░▒▒▒░▒▓▒░▒▒▓░░░░░░░░░░░░░░░░░▓▒▒▒▒▒▓▒░░░░▒▒▓░░░░░░░░░░▒░░░░░░░░░▒▒░░░░▒▓▒▒░▒▒▒▓▒░░░░░░░▒▒▓▒▓▒▓▓▓▓▓▓▓▓▓▓▓▓▓▓▓█▓█▓▓▓▓▓▓▓▓██▓▓▒▒░▓▓▓▓▓▓▓▓▓▓▓▓▓█▓█▓▓▓▓█▓▓▓▓▓▓▓▓▒▒▒▒▒▒▒░░░░░░▒▓▒▒░▒░▓▒▒░░░▒▒▒░░░░░░░░░░░░░░░░░░░░░▒░░░░░░░░░░░░
▒▒▒▒▒▒▒▒▒▒▒▒▒▒▒▒▒▒▒▒▒▒▒▒▒▒▒▒▒▒▒▒▒▒▒▒▓▒▓░▒▓▒▒░░▒▓▓▓▒▓▓▓▓▓▓▓▓▓▓▓▓▒▒▓▒▓▒░▓▒▓▒▒▒▒▒▒▓▒▒▒▓▒░▒▒▓▓▓▓▓▓▓▓▓▓▓▓▓▓▓▓▓▓█▒▒▒▒▒▓▒▒░░░▒▒▓░░░░░░░░░░▒░░░░░░░░░▓▒░░░░▒▓▒▒░▒▒▒▓▒░░░░░░░▒▒▓▒▓▒▓▓▓▓▓▓▓▓▓▓▓▓▓▓▓▓▒▓▓▓▓▓▓▓▒▓█▓▓▓▒▒░▓▓▓▓▓▓▓▓▓▓▓▓▓▓▓▓▓▓▓▓▓▓▓▓▓▓▓▓▓▓▓▓▓▓▒▒▒▒▒▒▒▒▒▒▒▒▒▒░▓▓▒▒▒▒▓▒▒▒▒▒▒▒▒▒▒▒▒▒▒▒▒▒▒▒▒▒▒▒▒▒▒▒▒▒▒▒▒▒▒▒▒
▒▒▒▒▒▒░░░░░░░░░░░░░░░░░░░░░░░░░░░░░░░░░░▒▓▒▒░░▒▓▓▓▓▒▒▒▒▓▒▒▒▒▒▓▒░▒▓▒▒▒░▓░░░░░░░░░░░▒▓▒░░░░░░░░░░░░░░░░░░░░░▓▒▒▒▒▒▓▒░░░░▒▒▓░░░░░░░░░░▒░░░░░░░░░▓▒░░░░▒▓▒▒░▒▒▒▓▒░░░░░░░▒▒▓▒▓▒▓▒▒▓▒▓▓▒▓▒▒▓▒▓▒▓░▓▒▒▒▒▒▓▒▒▓▓▓▓▒▒░▓▓▓▓▓▓▓▓▒▓▓▒▓▓▒▓▒▓▓▓▓▓▓▓▓▓▓▓▓▒▒▒▒▒▒▒▒░░░░░░░░░░▒░░░░░░░░░░░░░░░░░░░░░░░░░░░░░░░░░░░░░░░░░░░░
░░░░░░░░░░░░░░░░░░░░░░░░░░░░░░░░░░░░░░░░▒▓░▒░░▒▓▓▓▓▓▓▓▒▒░░░░░▒▒▒▒▓▒▓▒░▓░░░░░░░░░░░▒▓▒░░░░░░░░░░░░░░░░░░░░░▓▒▒▒▒▒▓▒▒▒▒▒▒▒▓░░░░░░░░░░▒░░░░░░░░░▒▒░░░░▒▓▒▒░▒▒▒▓▒░░░░░░▒▒▒▓▒▓▒▓▒░▓▒▒▒░▓▒░▓▒▓░▓░▓░▒░▒▒▓▒▒▓▓▒▓▒▒░▓▓▓▒▓▓▓█▓▓▓▓▓█▓▓▓▓▓▓▓▓▓▓▓▓▓▓▓▒▒▒▒▒▒▒▒▒░░░░░▒▒░░▒░░░░░░░░░░░░░░░░░░░░░░░░░░░░░░░▒░░░░░░░░░░░░
░░░░░░░░░░░░░░░░░░░░░░░░░░░░░░░░░░░░░░░░▒▓░▒░░▒▓▓▓▓▓▓▓░░░░░░▒▓▒░▒▓▒▓▒░▓▒▒▒▒▓▓▓▓▓▓▓▓▓▓▒▒▒▒▒▒▒▒▒▒▒▒▒▒▒▒▒▒▒▒▒▓▒▒▒▒▒▓▒▒▒▒▓▒▒▒▒▒▒▒▒▒▒▒▒▒▒▒▒▒▒▒▒▒▒▒▒▓░░░░▒▓▒▒░▒▒▒▓▓▒▒▒▒▒▒▒▓▓▓▓▓▒▓▒▒▓▒▒▒░▓▒▒▓▒▓░▓░▓░▒░▒▒▓▒▒▓▓▓▓▒▒░▓▓▓▓▓▒▓▓▓▓▒▒▒▒▒▒▒▒▒▒▒▒▒▒▒▒▒▓▓▓▓▓▓▓▓▓▓▓▓▓▓▒▒▒▒▒▒▒░░░░░░░░░░░░░░░░░░░░░░░░░░░░░░░▒░░░░░░░░░░░░
░░░░░░░░░░░░░░░░░░░░░░░░░░░░░░░░░▒▒▒▒▒▒▒▒▓░▒░░▒▓▓▓▓▓▓▒▒▒▒▒▒▒▒▒▓▒▒▓▒▓▒░▓▒▒▒▒░░░░░░░▒▒▒░░░░░░░░░░░░░░░░░░░░░▓▒▒▒▒▒▓▒▒▓▒▒▒▒▒▓▒░░░░░░░░▒░░░░░░░░░▒▒░░░░▒▓▒▒▒▒▒▒▓▒░░░░░░░▒▒▓▒▓▒▓▓▓▓▓▓▒▒▓▓▒▓▒▓▒▓▒▓▓▓▒▓▒▓▒▓▓▒▓▓▒▒░▓▓▓▓▓▓█▓▓▓▓▓▓▓▒▒▒▒▒▒▒▓▓▓▓▓▒▒▒▒▒▒▒▒▒▒▒▒▒▒▒▒█▓▓▓▓▓▒▒▒▓▓▓▓▓▓▓▓▓▓▓▓▒▒▒▒▒▒▒▒▒▒▒▒▒▒▒░▒░░░░░░░░░░░░
▒▒▒▒▒▒▒▒▒▒▒▓▓▓▓▓▓▓▓▓▓▓▓▒▒▒▒▒▒▒▒▒▒▒▓▓▓▓▓▓▓▓░▒░░▒▓▓▓▒▓░░░░░░░░░░░░▒▓▒▓▒░▓░░░▒▒▒▒▒▒▓▓▓▓▓▓▒▒▒▒▒▒▒▒▓▒▒▓▒▒▓▓▓▓▓▓█▒▒▒▒▒▓▒▒▒▓█▒▓▓▓▒░░░░░░░░▒░░░░░░░░░▒▒░░░▒▒▓▒▒░▒▒▒▓▓▒▓▒▓▓▓▓▓▓▓▒▓▒█▓▓▓▓▓▓▓▓▓▓▓▓▓▓▓▓▓▓▓▓▓▓▓▓▓▓▓▓▓▒▒░▓▓▓▓▓▓█▒▒░░░░░░▒▒▒▒▒▒▒▓▒▒▒▒▒▒▒▒▒▒▒▒▒▒▒▒▒▒▒▓▒▓▒▒▓░░░░░▒▒▒▒▒▒▒▓▓▓▓▓▓▓▓▓▓▓▓▓▓▒▒▒▒▒▒▒▒▒▒▒▒▒▒▒▓▓▓
▓▓▓▓▓▓▓▓▓▓▓▓▓▒▒▒▒▒▒▒▒▒▒▒▒▒▒▒▒▒░▒░░░░░░░░▒▓░▒░░▒▓▒▓▓▓░░░░░░░░░░░░▒▓▒▓▒░▓▓███▓▓▓▒▒▒▒▒▓▒░░░░░░░░░░░░░░░░░░░░░▓▒▒▒▒▒▓▒▒▓▓▓▒▒▒▒▒▒▒▒▒▒▒▒▒▒▒▒▒▒▒▒▒▒▒▒▓░░░░▒▓▒▒░▒▒▒▓▓░░░░░░░▒▒▓▒▓▒▓▓▓▓▓▓▓▓▓▓▒▒▓▒▓▓▒▒▒▓▒▒▒▓▓▓▓▓▓▓▒▒░▓▓▓▓▓▓█▒▒░░░▒▒▒▒░░░░░▒▓▒▒▒▒▒▒▒▒▒▒▒▒▒▒▒▒▒▒▒▓▒▒▒▒▓░░░░░░░░░░░░░░░░░░░░░░░░░░░▒▒▒▒▒▒▒▒▒▒▒▓▓▓▓▓▓
░░░░░░░░░░░░░░░░░░░░░░░░░░░░░░░░░░░░░░░░▒▓░▒░░▒▓▒▒░░░░░░░░░░░░░░▒▓▒▓▒░▓░░░░▒▒▒▒▓▒░▒▒▒░▒▓▒▒▒▒▒▒▒▒▒▒▒▒▒▓▓░░░▓▒▒▒▒▒▓▒▒▒▒▓▒▒▓▒▒▒▒▒▒▒▒▒▒▒▒▒▒▒▒▒▒▒▒▓▒░░░░▒▓▒▒░▒▒▒▓▓░▒▓▓▒▒▓▓▓▓▒▓▒██▓▓▓▓▓▓▓▓▓▓▓▓▓▓▓▓▓▓▓▓▓▓▓▓█▓▓▓▒▒░▓▓▓▓▓▓█▒▒░░░▒▒▓▒░░░░░▒▓▒▒▒▒▒▒▒▒▒▒▒▒▒▒▒▒▒▒▒▓▓▓▓▒▒░▒▓▒▒▒▒░░░░░░░░░░░░░░░░░░░░░░░░░░░░░░░░░░░░░
░░░░░░░░░░░░░░░░░░░░░░░░░░▒▒▒▒▒▒▒▒▒▒▒▒▓▓▓▓░▒░░▒▓▒▒░░░░░░░░░▒▒▒▓▒▒▓▒▓▒░▓▓▓▓▓▓▒▒▓▒▒░▒▒▒░▒▒▒░░░░░░░░░░░░▒▓░░░▓▒▒▒▒▒▓▒▒▒▒▒▒▒▓░░░░░░░░░░▒░░░░░░░░░▓▒░░░░▒▓▒▒░▒▒▒▓▓░▒▓▒░░▒▒▒▓▒▓▒▓▓▒▒▒▒▒▒▒▒▒▒▒▒▒▒▒▒▒▒▒▒▒▒▒▒▒▒▓▓▒▒░▓█▓▓▓▓█▒▒░░░░░▒░░░░░░▒▓▒▒▒▒▒▒▒▒▒▒▒▒▒▒▒▒▒▒▒▓▓▓▓▒▒░▓▒▓▓▓▓▓▓▓▓▒▒▒▒▒▒▒▒▒▒▒▒▒░░░░░░░░░░░░░░░░░░░░
░░░░░▒▒▒▒▒▒▒▒▒▓▓▓▓▓▓▒▒▒▒▒▒▓▓▓▓▓▓▓▓▓▒▒▒▒▒▒▓░▒░░▒▓▒▒░▒▒▓▓▓▓▓▓▓▓▓▒▒▒▓▒▓▒░▓▓░░░░▒░▒▒▒░▒▒▒░▒▒▒░░░░░░░░░░░░▒▓░░░▓▒▒▒▒▒▓▒░░░░▒▒▒░░░░░░░░░░▒░░░░░░░░░▓▒░░░░▒▓▒▒░▒▒▒▓▓░▒▓▒░░▒▒▒▓▒▓▒▒▒▒▒▒▒░▒▒▒▒░▒░▒▒▒▒▒▒▒▒▒▒▒▒▒▒▓▓▒▒░▓▓▓▓▓▒█▒▓▒▒▒░░░░░░░░░▒▓▒▒▒▒▒▒▒▒▒▒▒▒▒▒▒▒▒▒▒▓▓▓▓▒▒░▓▒▓░░░▒▒░░▒▒▒▒▓▓▓▓▓▓▓▓▓▒▒▒▒▒▒▒▒▒▒▒▒▒▒▒▒▒░░░
▒▒▒▒▒▒▒▒▓▓████▓▓▓▓▒▒▒▒▒░░░░░░░░░░░░░░░░░▒▓░▒░░▒▓▒▒░░▒▓▒░░░░░░▒▒░▒▓▒▒▒░▓▓░░░░▒░▒▒▒░▒▒▒░▒▒▒░░░░░░░░░░░░▒▓░░░▓▒▒▒▒▒▓▒░░░░▒▒▓▒▒▒▒▒▒▒▒▒▒▒▒▒▒▒▒▒▒▒▒▓▒░░░░▒▓▒▒░▒▒▒▓▓░▒▓▒░░▒▒▒▓▒▓▒▒▒░▒░░░░▒░░░░░░░░░░░░░░░░░░░▒▓▒▒░▓▓▒▓▓▒█▒▓▓▒▒▒░▒▒▒▒▒░░▒▓▒▒▒▒▒▒▒▒▒▒▒▒▒▒▒▒▒▒▒▓▓▓▓▒▒░▓▒▒░░░▒▒░░░░░░░░░░░░░░░░░░░▒▒▓▓▓▓▓▓██▓▓▒▒▒▒
▓▒▒▒▒▒▒▒▒░░░░░░░░░░░░░░░░░░▒▒▒▒▒▒▒▓▓▓▒▒░▒▓░▒░░▒▓▒▒░░▒▒░░░░░░░▒▒░▒▓▒▒▒░▓▒░░░░░░▒▒▒░▒▒▒░▒▒▒░░░░░░░░░░░░▒▓░░░▓▒▒▒▒▒▓▒▒░░░▒▓▓▓▓▓▓▓▓▓▓▓▓▓▓▓▓▓▓▓▓▓▓▓▓░░░░▒▓▒▒░▒▒▒▓▓░▒▓▒░░▒▒▒▓▒▓▒▒▒░▒░░░░░▒▒▒▒▒▒▒▒▒▒░░░░░░░░░▒▓▒▒░▓▓▒▓▒▒█▒▒░░░░▒▒▒▒▒▓▒▒▒▓▒▒▒▒▒▒▒▒▒▒▒▒▒▒▒▒▒▒▒▓▓▓▓▒▒░▓▒▒░░░▒▒░░░░░░░░░░░░░░░░░░░░░░░░░░░░░░▒▒▒▒▒
░░░░░░░░░░░░░▒▒▒▒▒▒▒▓▓▓▓▓▓▒▒▒▒▒░░░░▒▓▒▒░▒▓░▒░░▒▓▒▒░░▒▒░░░░░░░▓▒░▒▓▒▓▒░▓▒░░░░▒░▒▒▒░▒▒▒░▒▒▒░░░░░░░░░░░░▒▓░░░▓▒▒▒▒▒▓▒░░░░▒▒▒▒░░░░░░░░░▒░░░░░░░░░▒▒░░░░▒▓▒▒░▒▒▒▓▓░▒▓▒░░▒▒▒▓▒▓▒▒▒░▒░░░░░░▒▒▒▒▒▒▒▒░░░░░░░░░░▓▓▒▒░▓▓▒▓▒▒█▒▒░▒▒▒▒▒▒▒▒░░░▒▓▒▒▒▒▒▒▒▒▒▒▒▒▒▒▒▒▒▒▒▓▓▓▓▒▒░▓▒▒░░░▒▒░░░░░░░░░░░░░░░░░░░░░░░░░░░░░░░░░░░
▒▒▒▒▒▒▒▓▓▒▓▓▓▓▓▒▒░░░░░░░░░░░░░░░░░░▒▒▒▓░▒▓░▒░░▒▓▒▒░░▒▒░░░░░░░▒▒░▒▓▒▒▒░▓▒░░░░▒░▒▒▒░▒▒▒░▒▒▒░░░░░░░░░░░░▒▓░░░▓▒▒▒▒▒▓▒░░░░▒▒▒░░░░░░░░░░▒░░░░░░░░░▓▒░░░░▒▓▒▒░▒▒▒▓▓░▒▓▒░▒▒▒▒▓▒▓▒▒▒░▒░░░░░░░░░░░░░░░░░░░░░░░░▓▓▒▓░▓▓▓▓▓▓█▒▓▒▒▒▒░░░░░░▒▒▒▓▒▒▒▒▒▒▒▒▒▒▒▒▒▒▒▒▒▒▒▓▓▓▓▒▒░▓▒▒░░░▒▒░░░░░░░░░░░░░░░░░░░░░░░░░░░░░░░░░░░
▓▓▒▒░░░░░░░░░░░░░░░░░░░░░░░░░░░░░░░▒▒▒▓░▒▓░▒░░▒▓▒▒░░▒▒░░░░░░░▒▒░▒▓▒▓▒░▓▒░░░░▒░▒▒▒░▒▒▒░▒▒▒░░░░░░░░░░░░▒▓░░░▓▒▒▒▒▒▓▒░░░░▒▒▒░░░░░░░░░░▒░░░░░░░░░▓▒░░░░▒▓▒▒░▒▒▒▓▓░▒▓▒░▒▒▒▒▓▒▓▒▓▓▓▓▓▓▓▓▓▓▓▓▓▓▓▓▓▓▓▓▓▓▓▓▓▓▓▓▓▓▒▒░▓▓▓▓▓▓▓▒▓▒▓▓▓▒▒▓▓▒▒▒░▒▓▒▒▒▒▒▒▒▒▒▒▒▒▒▒▒▒▒▒▒▓▓▓▓▒▒░▓▒▒░░░▒▒░░░░░░░░░░░░░░░░░░░░░░░░░░░░░░░░░░░
░░░░░░░░░░░░░░░░░░░░░░░░░░░░░░░░░░░▒▒▒▓░▒▓░▒░░▒▓▒▒░░▒▒░░░░░░░▓▒░▒▓▒▓▒░▓▒░░░░▒░▒▒▒░▒▒▒░▒▒▒░░░░░░░░░░░░▒▓░░░▓▒▒▒░▒▓▒▒░░░▒▒▒░░░░░░░░░░▒░░░░░░░░░▓▒░░░░▒▓▒▒░▒▒▒▓▓░▒▓▒░▒▒▒▒▓▒▓▒▓▓▓▓▓▓▓▓▓▓▓▓▓▓▓▓▓▓▓▓▓▓▓▓▓▓▓▓▓▓▒▓░▓▓▓▓▓▓█▒▓░░░░▒▒▒▒▓▓▓▒▓▓▒▒▒▒▒▒▒▒▒▒▒▒▒▒▒▒▒▒▒▓▓▓▓▒▒░▓▒▒░░░▒▒░░░░░░░░░░░░░░░░░░░░░░░░░░░░░░░░░░░
░░░░░░░░░░░░░░░░░░░░░░░░░░░░░░░░░░░▒▒▒▓░▒▓░▒░░▒▓▒▒░░▒▒░░░░░░░▒▒░▒▓▒▓▒░▓▒░░░░▒░▒▒▒░▒▒▒░▒▒▒░░░░░░░░░░░░▒▓░░░▓▒▒▒▒▒▓▒░░░░▒▒▒░░░░░░░░░░▒░░░░░░░░░▓▒░░░░▒▓▒▒░▒▒▒▓▓░▒▓▒░▒▒▒▒▓▒▓▒▒▒░▒░░░░░░░░░░░░░░░░░░░░░░░░▓▓▒▓░▓▓███▓█▒▒░░░▒▒▒▒░░░▒▒▒▓▒▒▒▒▒▒▒▒▒▒▒▒▒▒▒▒▒▒▒▓▓▓▓▒▒░▓▒▒░░░▒▒░░░░░░░░░░░░░░░░░░░░░░░░░░░░░░░░░░░
░░░░░░░░░░░░░░░░░░░░░░░░░░░░░░░░░░░▒▒▒▓░▒▓░▒░░▒▓▒▒░░▒▒░░░░░░░▒▒░▒▓▒▒▒░▓▒░░░░▒░▒▒▒░▒▓▒░▒▒▒░░░░░░░░░░░░▒▓░░░▓▒▒▒▒▒▓▒░░░░▒▒▒░░░░░░░░░░▒░░░░░░░░░▓▒░░░░▒▓▒▒░▒▒▒▓▓░▒▓▒▒▒▒▒▒▓▒▓▒▒▒░▒░░░░░░░▒▒▒▒▒▒▒░░░░░░░░░░▓▓▒▓░▓▓▓▓▓▓▓▒▓░░░░▒▒▒░░░░▒▒▓▒▒▒▒▒▒▒▒▒▒▒▒▒▒▒▒▒▒▒▓▓▓▓▒▒░▓▒▒░░░▒▒░░░░░░░░░░░░░░░░░░░░░░░░░░░░░░░░░░░
░░░░░░░░░░░░░░░░░░░░░░░░░░░░░░░░░░░▒▒▒▓░▒▓░▒░░▒▓▒▒░░▒▒░░░░░░░▒▒░▒▓▒▒▒░▓▒░░░░▒░▒▒▒░▒▒▒░▒▒▒░░░░░░░░░░░░▒▓░░░▓▒▒▒▒▒▓▒░░░░▒▒▒░░░░░░░░░░▒░░░░░░░░░▓▒░░░░▒▓▒▒░▒▒▒▓▓░▒▓▒▒▒▒▒▒▓▒▓▒▒▒░▒░░░░░░▓▓▓▓▓▓▓▓▒░░░░░░░░░▓▓▒▓░▓▓▓▓▓▓▓▒▒▒▒▒▒░░░░░░░▒▒▓▒▒▒▒▒▒▒▒▒▒▒▒▒▒▒▒▒▒▒▓▓▓▓▒▒░▓▒▒░░░▒▒░░░░░░░░░░░░░░░░░░░░░░░░░░░░░░░░░░░
░░░░░░░░░░░░░░░░░░░░░░░░░░░░░░░░░░░▒▒▒▓░▒▓░▒░░▒▓▒▒░░▒▒░░░░░░░▒▒▒▒▓▒▓▒░▓▒░░░░▒░▒▒▒░▒▒▒░▒▒▒░░░░░░░░░░░░▒▓░░░▓▒▒▒▒▒▓▒░░░░▒▒▒░░░░░░░░░░▒░░░░░░░░░▓▒░░░░▒▓▒▒░▒▒▒▓▓▒▒▓▒▒▒▒▒▒▓▓▓▒▒▒░▒░░░░░░░░░░░░░░░░░░░░░░░░▓▓▒▓░▓▓▓▓▓▓▓▒▒▒▓▒░▒▒▒░░░░▒▒▓▒▒▒▒▒▒▒▒▒▒▒▒▒▒▒▒▒▒▒▓▓▓▓▒▒░▓▒▒░░░▒▒░░░░░░░░░░░░░░░░░░░░░░░░░░░░░░░░░░░
░░░░░░░░░░░░░░░░░░░░░░░░░░░░░░░░░░░▒▒▒▓░▒▓▒▒░░▒▓▒▒░░▒▒░░░░░░░▒▒░▒▓▒▓▒░▓▒░░░░▒░▒▒▒░▒▒▒░▒▒▒░░░░░░░░░░░░▒▓░░░▓▒▒▒▒▒▓▒░░░░▒▒▒░░░░░░░░░░▒░░░░░░░░░▓▒░░░░▒▓▒▒░▒▒▒▓▓▒▒▓▒▒▒▒▒▒▓▓▓▒▓▒▒▒▒▒▒▒▒▒▒▒▒▒▒▒▒▒▒▒▒▒▒▒▒▒▒▒▓▓▒▓░▓▒▒▒▒▓▓▒▓▒░░░▒▒▒▒░▒▒▒▒▓▒▒▒▒▒▒▒▒▒▒▒▒▒▒▒▒▒▒▒▓▓▓▓▒▒░▓▒▒░░░▒▒░░░░░░░░░░░░░░░░░░░░░░░░░░░░░░░░░░░
░░░░░░░░░░░░░░░░░░░░░░░░░░░░░░░░░░░▒▒▒▓░▒▓░▒░░▒▓▒▒░░▒▒░░░░░░░▒▒░▒▓▒▓▒░▓▒░░░░▒░▒▒▒▒▒▒▒░▒▒▒▒░▒░▒░▒░░░░▒▒▓░░░▓▒▒▒▒▒▓▒░░░░▒▒▒░░░░░░░░░░▒░░░░░░░░░▓▒░░░░▒▓▒▒░▒▒▒▓▓▒▒▓▒▒▒▒▒▒▓▓▓▓▓▒▒▒▒▒▒▒▒▒▒▒▒▒▒▒▒▒▒▒▒▒▒▒▒▒▒▒▒▓▒▓░▓██▓▓██▒▒░▒▒▒▒░░░▒▒▒▒▒▓▒▒▒▒▒▒▒▒▒▒▒▒▒▒▒▒▒▒▒▓▓▓▓▒▒░▓▒▒░░░▒▒░░░░░░░░░░░░░░░░░░░░░░░░░░░░░░░░░░░
░░░░░░░░░░░░░░░░░░░░░░░░░░░░░░░░░░░▒▒▒▓░▒▓▒▒░░▒▓▒▒░░▒▒░░░░░░░▒▒░▒▓▒▒▒░▓▓░░░░░░▒▒▒░▒▒▒░▒▓▒▒▒▒▒▒▒▒▒▒▒▒▒▒▓░░░▓▒▒▒▒▒▓▒▒░░░▒▒▒░░░░░░░░░░▒░░░░░░░░░▓▒░░░░▒▓▒▒░▒▒▒▓▓▒▒▓▓▓▓▓▓▓▓▓▓▒▒░░░░░░░░░░░░░░░░░░░░░░░░░░░▒▒▒▓░██▓█▓██▒▒░░░░░▒▒▒▒░░░▒▓▒▒▒▒▒▒▒▒▒▒▒▒▒▒▒▒▒▒▒▓▓▓▓▒▒░▓▒▒░░░▒▒░░░░░░░░░░░░░░░░░░░░░░░░░░░░░░░░░░░
░░░░░░░░░░░░░░░░░░░░░░░░░░░░░░░░░░░▒▒▒▓░▒▓░▒░░▒▓▒▒░░▒▒░░░░░░░▒▒░▒▓▒▓▒░▓▓░░░▒▒▓▓▒▒▒▓█▓▒▒▒▓▓▒▓▒▒▓▓▒▓▒▒▒▒▒▒▒▒█▒▒▒▒▒▓▒░░░░▒▒▒▒▒▒▒▒▒▒▒▒▒▒▒▒▒▒▒▒▒▒▒▓▒░░░░▒▓▒▒░▒▒▒▓▓▓▓▓▓▓▓▓▓▓▓▓▓▒▒▒▒░▒▒▒▒░▒▒▒▒▒▒▒▒▒▒▒▒▒▒▒▒▒▒▒▒▒▒▒░█▓▓█▓▓█▒▓▓▒░░░░░░░▒▓▒▒▓▒▒▒▒▒▒▒▒▒▒▒▒▒▒▒▒▒▒▒▓▓▓▓▒▒░▓▒▒░░░▒▒░░░░░░░░░░░░░░░░░░░░░░░░░░░░░░░░░░░
░░░░░░░░░░░░░░░░░░░░░░░░░░░░░░░░░░░▒▒▒▓░▒▓░▒░░▒▓▒▒░░▒▒░░░░░░░▒▒░▒▓▒▓▒░▓▓▒▓▒▒▒▒▓█▓▒▒▓▓▒▒▒▒▒▒▒▒▒▒▒▒▒▒▒▒▒▒▒▒▒▓▒▒▒▒▒▓▒▒░░░▒▒▒▒▒▒▒▒▒▒▒▒▒▒▒▒▒▒▒▒▒▒▒▒▒░░░░▒▓▒▒░▒▒▒▓▓▓▓▓▓▓▓▓▓▓▓▓▓▒█▓▓▓▓▓▓▓▓▓▓▓▓▓▓▓▓▓▓▓▓▓▓▓▓▓▓▓▓█▒▓░█▓▒▓▒▓▓▒▓▒▓▒▓▒░░░░░░░▒▓▒▒▒▒▒▒▒▒▒▒▒▒▒▒▒▒▒▒▒▓▓▓▓▒▒░▓▒▒░░░▒▒░░░░░░░░░░░░░░░░░░░░░░░░░░░░░░░░░░░
░░░░░░░░░░░░░░░░░░░░░░░░░░░░░░░░░░░▒▒▒▓░▒▓░▒░░▒▓▒▒░░▒▒░░░░░░░▒▒░▒▓▒▓▒░▓▒▒▒▒▓▓▒▒▒▒▒▒▒▒░░░░░░░░░░░░░░░░░░░░░▓▒▒▒▒▒▓▒░░░░░░▒░░░░░░░░░░▒░░░░░░░░░▒▒░░░░▒▓▒▒░▒▒▒▓▓▒▒▒▒▒▒▒▒▒▓▒▓▒▒▒░░░░░░▒░░░░░░░░░░░░░░░░░░░▒▓▒▓▒█▓▒▓▒▓▓▒▓▒▒▒▒▓▓▒▒▒░░░▒▓▒▒▒▒▒▒▒▒▒▒▒▒▒▒▒▒▒▒▒▓▓▓▓▒▒░▓▒▒░░░▒▒░░░░░░░░░░░░░░░░░░░░░░░░░░░░░░░░░░░
░░░░░░░░░░░░░░░░░░░░░░░░░░░░░░░░░░░▒▒▒▓░▒▓░▒░░▒▓▒▒░░▒▒░░░░░░░▒▒░▒▓▒▓▒░▓▓▓▓▒▒▒▒░░░░▒▒▒▒▒▒▒▒▒▒▒▒▒▒▒▒▒▒▒▒▒▒▒▒▓▒▒▒▒▒▓▒▒░░░░░▒░░░░░░░░░░▒░░░░░░░░░░░░░░░▒▓▒▒░▒▒▒▓▓▒▒▒▒▒▒▒▒▒▓▓▓▒▒▒░░░░░░░░▓▓▓▓▓▓▓▓▒░░░░░░░░░▓▓▒▓▒█▓▒▓▒▓▓▒▓▒▒▒▒▒▒▒▓▓▒▒▒▒▓▒▒▒▒▒▒▒▒▒▒▒▒▒▒▒▒▒▒▒▓▓▓▓▒▒░▓▒▒░░░▒▒░░░░░░░░░░░░░░░░░░░░░░░░░░░░░░░░░░░
░░░░░░░░░░░░░░░░░░░░░░░░░░░░░░░░░░░▒▒▒▓░▒▓▒▒░░▒▓▒▒░░▒▒░░░░░░░▓▒░▒▓▒▒▒░▓▒▒▓▒░░░░░░▒▒▓▒▒▒▒▒▒▒▒▒▒▒▒▒▒▒▒▒▒▒▒▒▒▓▒▒▒▒▒▓▓▓▓▓▓▓▓▓▓▓▓▓▓▒▓▒▒▓▓▒▓▒▒▒▒▓▓▒▓▓▓▓▓▓▓▓▓▒░▒▒▒▓▓▓▓▓▓▓▓▓▓▓▓▓▓▒▒▒░░░░░░░░▒▒▒▒▒▒▒▒░░░░░░░░░░▓▓▒▓▒█▓▓▓▓▓█▓▓▒▒▒▓▒▒▓▒▒▒▓▓▒▓▒▒▒▒▒▒▒▒▒▒▒▒▒▒▒▒▒▒▒▓▓▓▓▒▒░▓▒▓░░░▒▒░░░░░░░░░░░░░░░░░░░░░░░░░░░░░░░░░░░
░░░░░░░░░░░░░░░░░░░░░░░░░░░░░░░░░░░▒▒▒▓░▒▓▒▒░░▒▓▒▒░░▒▒░░░░░░░▓▒░▒▓▒▒▒░▓░░░░░░░▒▒▒▒▒▓▒░░░░░░░░░░░░░░░░░░░░░▓▒▒▒▒▓▒▒▒▒▒▒▒▒▒▒▒░▒▒▒▒▒▒▒▒▒▒▒▒▒▒▒▒▒▒▒▒▒▒▒▒▒▓▒░▒▒▒▓▓▒▒▒▒▒▒▒▒▒▓▓▓▒▒▒░░░░░░░░░░░░░░░░░░░░░░░░░░▓▓▒▓▒▓▒▒▒▒▒▓▓▓▒▒▓▒▒▒▒▒▒▒▒▒▓▓▒▒▒▒▒▒▒▒▒▒▒▒▒▒▒▒▒▒▒▓▓▓▓▒▒░▓▒▓░░░▒▒░░░░░░░░░░░░░░░░░░░░░░░░░░░░░░░░░░░
░░░░░░░░░░░░░░░░░░░░░░░░░░░░░░░░░░░▒▒▒▓░▒▓▒▒░░▒▓▒▒░░▒▒░░░░░▒▒▓▒░▒▓▒▒▒░▓░░░░▒▒▒▒▒▒▓▓▓▒▓▒▓▓▒▒▒▒▓▓▒▒▒▒▒▒▓▓▓▓▓█▒▒▒▒▒▒░░░░░░░░░░░░░░░░░░░░░░░░░░░░░░░░░░░░▒▒░▒▒▓▓▓▓▓▓▓▓▓▓▓▓█▓▓▒▒▒▒▒▒▒▒▒▒▒▒▒▒▒▒▒▒▒▒▒▒▒▒▒▒▒▒▒▒▒▒▓▒▓▓▓▓▓▓▓▒▓▓▓▒▒▒▒▒▒▒▒▒▒▒▓▒▒▒▒▒▒▒▒▒▒▒▒▒▒▒▒▒▒▒▓▓▓▓▒▒░▓▒▓░░░▒▒░░░░░░░░░░░░░░░░░░░░░░░░░░░░░░░░░░░
░░░░░░░░░░░░░░░░░░░░░░░░░░░░░░░░░░░▒▒▒▓░▒▓▒▒░░▒▓▒▒░░▒▒░░▒▒░░░▓▒▒▒▓▒▓▒░▓░░▒▒▒▒▒▓▓▒▒▒▒▒▒▒▒░░░▒▓▒░░░░▒▓▒░░░░▓█▓▓▓▓▓▓▓▓▓▓▓▓▓▓▓▓▓▓▓▓▓▓▓▓▓▓▓▓▓▓▓▓▓▓▓▓▓▓▓▓▓▓▓▓▓▓▓▓█▓▓▓▒▒░▒░▒▒▓▓▓▒▒▒▓▓▓▓▓▓▓▓▓▓▓▓▓▓▓▓▓▓▓▓▓▓▓▓▓▓▒▒▒▓██▓▓████▒▓▓▒▓▓▓▒▒▒▒▒▒▒▒▓▒▒▒▒▒▒▒▒▒▒▒▒▒▒▒▒▒▒▒▓▓▓▓▒▒░▓▒▓░░░▒▒░░░░░░░░░░░░░░░░░░░░░░░░░░░░░░░░░░░
░░░░░░░░░░░░░░░░░░░░░░░░░░░░░░░░░░░▒▒▒▓░▒▓▒▒░░▒▓▒▒░░▒▒▒░░░░░▒▓▒▒▒▓▒▓▒░▓▒▒▒▒▓▓▒▒▒▒▒▒▒▒░░░░▒▓▒░░░░░▓▒░░░░▒▓▒░░░░▒▒░░░▒▓░░░░░░░▒▒▒░░░░░░▒▒░░░░▓░░░▒░▒▒▒░░░░░▒▒░░░▒▒▒░░▒▒▒░▒▓▒▓██▓██▓▓▓▓▓█▓▓▓▓▓▓█▓▓▓▓▓▓████▓▒▓▓▓▓▓▓▓▓█▓████▓▓▓▓▒▒▒▒▓▒▓▒▒▒▒▒▒▒▒▒▒▒▒▒▒▒▒▒▒▒█▓▓▓▒▒░▓▒▓░░░▒▒░░░░░░░░░░░░░░░░░░░░░░░░░░░░░░░░░░░
░░░░░░░░░░░░░░░░░░░░░░░░░░░░░░░░░░░▒▒▒▓░▒▓▒▒░░▒▓▒▒▒▒▒▒░░▒▒▒▒▒▒░░▒▓▒▓▒░▓▒▒▓▒▒▒▒▒░▒▓▒░░░░▒▓▒░░░░░▒▒░░░░░▒▒░░░░░▓▒░░░▒▓░░░░░░░░▒▓▒░░░░░░▒▒░░░▒▒░░░▒░▒▒▒▒░░░░░▒░░░░▓▒░░░▒▒░░▒▓▓▒▒▒▒▓▓▒▒▒▒▒▓▒▒▒▒▒▒▒▓▒▒▒▒▒▒▒▒▓▓▒▒▒▒▒▓▓▒▒▒▒▓▓███▓▒▓▓▒▒▒▒▓▒▒▒▒▒▒▒▒▒▒▒▒▒▒▒▒▒▒▒█▓▒▓▒▒░▓▒▓░░░▓▒░░░░░░░░░░░░░░░░░░░░░░░░░░░░░░░░░░░
░░░░░░░░░░░░░░░░░░░░░░░░░░░░░░░░░░░▒▒▒▓░▒▓▒▒░░▒▓▒▒░░▒▒▒▒▒▒▒░░░░░▒▓▒▓▓▒▓▒▒▒▒▒▒░▒▓░░░░░▒▓░░░░░░▒▓░░░░░▒▓░▒░░░░▓▒░░░▒▓░░░░░░░░▒▒▒░░░░░░░▓░░░░▓░░░░▒░▒░▓▒░░░░░░▒░░░▒▓▒░░░▒▒░░░░▓░░░░▒▒░░░░░▒▒░░░░░░▒▒░░░░░░░▒▓░░░░░░▓▓▒▒▒▒▓▓▓██▓▒▓▓▒▓▓▒▒▒▒▒▒▒▒▒▒▒▒▒▒▒▒▒▒▒▓▓▓▓▓▓░▓▒▒▒▒░▓▒░░░░░░░░░░░░░░░░░░░░░░░░░░░░░░░░░░░
░░░░░░░░░░░░░░░░░░░░░░░░░░░░░░░░░░░▒▓▒▓░▒▓▒▒░░▒▓▒▒▒▒▒▓▒▒░░░░░▒▒▓▓▓▒▒▒░▒▒▒▒▒░▓▒░░░░░▒▓▒░░░░░▒▓▒░░░░░▒▒▒▒░░░▒▓░░░░▒▒░░▒░░░░░▒░▒░░░░░░░▒▓▒▒▒▒▓░░░░▒░▒▒▓▒░░░░░░▒░░░░▓▒░░░░▒▒░░░░▒░░░░▒▒░░░░░▒▓▒░░░░░▒▓▒░░░░░░░▒▒░░░░░▒▒▓▒▒▒▒▒▓▓███▒▒▓▓▒▒▒▒▒▒▒▒▒▒▒▒▒▒▒▒▒▒▒▓▓▒▒▓█▒▒▓▒░░░▒▓▒▒▒░░░░░░░░░░░░░░░░░░░░░░░░░░░░░░░░
░░░░░░░░░░░░░░░░░░░░░░░░░░░░░░░▒▒▒▓▒▒▒▒░▒▓▒▒░░▒▓▒▒▒▒▒░░░░░░▒▓▓▒▒▒▒░▒▒▒▒▒░▒▒▒░░░░░▒▓▒░░░░▒▒▓▒░░░░░▒▓▒▒░░░░▒▓░░░░▒▓░░░░░░░░▒▒▓▒░░░░░░░▓░░░░▒▒░░░░▒░▒▒▓░▒░░░░░▒▒░░░▒▒░░░░░▓▒░░░▒▓░░░░▒▓░░░░░░▒▒░░░░░░▒▓░░░░░░░▒▓▒░░░░░▒▓▓▓▓▓▓▓▓▓▓█▓▒▓▒▒▒▒▒▒▒▒▒▒▒▒▒▒▒▒▒▒▒▓▓▓▓▓▓▒▒▒▒▓▓▓▒░░▒▒▒▒▒▒░░░░░░░░░░░░░░░░░░░░░░░░░░░░
░░░░░░░░░░░░░░░░░░░░░░░░░░░▒▒▒▒▒▒▒▒░░▒▓▓▓▓▒▒░░▒▓▒▒░░░░░░▒▓▓▒▒▒▒░▒▒▒▒▒▒░▒▒░░░░░░▒▓▒▒▒▒▒▒▒▓▒░░░░░░▒▒▒▒░░░░▒▓▒▒▒▒▒▒░░░░░░░░░░▒▒░░░░░░░▒▒░░░░▒▒░░░▒▒░▒▒▓▒▒▒▒▒▒▒▒▒░░░░▓▒▒▒▒▒▒▓░░░░░▒░░░░▒▓░░░░░░▒▓░░░░░░░▓▒░░░░░░░▒▓▒▒▒▒▒▒▒▓▓▒▒▒▒▒▓▓█▓▓▒▒▒▒▒▒▒▒▒▒▒▒▒▒▒▒▒▒▒▓▒▒▒▓▓▒▒▒░░▒▒▓▓▓▒░░░▒▒▒▒▒▒░░░░░░░░░░░░░░░░░░░░░░░░
░░░░░░░░░░░░░░░░░░░░░░░▒▒▓▒▒▓░▒▒░░▒▓█▓▒▒▒▓▒▒░░▒▓▒░░░░▒▒▓▒▒▒▒░░▒▓▒▒▒░░▒▒░░░░░░▒▓░░░░░░░▒▓░░░░░░░▓░▒░░░░░▓▒░░░░▒▓░░░░░░░░░░▒▒░░░░░░░░▒▒░░░░▒▒░░░▒░░▒▒▓░░░░░░░░▒▒░░░░▓░░░░░▒▒░░░░▒▓░░░░░▓▓▓▓▓▓▓▓▓▒░░░░░░▒▓▒░░░░░░░▒▓▒▒▒▒▒░░▒▓▒▒▒▒▒▓▓▓▒▒▓▓▓▓▓▓▓▓▓▓▓▓▓▓▓▒▒▓▒▒▒▒▓▒▒▒▒▒▒▒░▒▒▓▓▓▒▒░░▒▒▒▒▓▒░░░░░░░░░░░░░░░░░░░░░
░░░░░░░░░░░░░░░░░░░░▒▓▒▒▓▒░▒░░░▒█▓▒▒▒▒▓▒▒▓▒▒░░▒▓▒░░▓▓▒▓▒▒▒░▒▓▒▒▒▒░░▓▒░░░░░░▒▓▒░░░░░░░▓▒░░░░░░▒▒▒▒░░░░░▓▒░░░░▒▒░░░░░░░░░░▒▓░░░░░░░░░▓░░░░░▒▒░░░▒░░▒▒▓░░░░░░░░▒▒░░░░▒▒░░░░░▒▒░░░░░▒░░░░░▓░░░░░░░▒▓░░░░░░░▒▒░░░░░░░░▒▒░░░░░░░▒▓▒▒▒▒▒████▓█▓▓▓██▓▓█▓██▓██▓▓▓▒▓▓▒░░░▒▒▒▒▓▒░░▒▒▓█▓░░░░▒▓▒▓▓░░░░░░░░░░░░░░░░░░
░░░░░░░░░░░░░░░░▒▓▒▒▓▒▒░░░░▒▓█▓▒▒▒▓▒▒░░░▒▓▒▒░░▒▓▒▓▒▒▒▒▒░▒▓▒▒▒▒▒░▒▓▒░░░░░░▒▓▒░░░░░░░▓▒░░░░░░░▓▒▒▒░░░░░▓░░░░░▒▒░░░░░░░░░░░▒░░░░░░░░░▒▒░░░░░▓░░░░▒░░▒▒▓░░░░░░░░▒▒░░░░░▓░░░░░░▒▒░░░░▒▓░░░░░▒▒░░░░░░▒▓▒▒▒▒▒▒▒▒▒▒░░░░░░░░▓▒░░░░░░░▒▒░░░░▒▒▓▒▒▒▓▓▒▒▓▓▒▒▓▓▓▓▒▒▒▓▓▓█▒░░░░░▒▒▒▒▒▒▒░░▒▒▓▓▓▒░░░▒▒▒▒▓▒░░░░░░░░░░░░░░
░░░░░░░░░░░░▒▒▒▒▒▒▒░░░░▒▓▓▓▓▒▒▒▒▒░░░░░░░░▓▒▒░▒▓▓▒▒▒▒░░▒▒▒▒▒▒░░▒▓▒░░░░░░▒▓▒▒░░░░░░▒▒░░░░░░░▒▒░▒░░░░░▒▓▒░░░░▒▒░░░░░░░░░░░▒▓▒▒▒▒▒▒▒▒▒▓░░░░░░▓░░░░▒░░▒▒▓░░░░░░░░░▒▒░░░░▒▓░░░░░░▓░░░░░░▒░░░░░▓▒░░░░░░░▒▒▒▒░░░░░▒▒░░░░░░░░▒▓▒░░░░░░░▒▓░░░░░▒▓▒▒▒▓▓▒▒▒▓▓▒▓▓▓▓▓▒▒▓▓▒▒▒▒░░░░░░▒▒▒▒▒▒░░▒▒▒▓▓▓▒░░▒▒▒▒▒▒▒░░░░░░░░░░
░░░░░░░░▒▒▓▒▒▓▒░░░░░▒▓▓▓▒▒▒▒▓▒░░░░░░░░░░▒▓▓▓▓▒▒▒▒▒░▒▒▒▒▒▒░░░▒▓▒░░░░░░▒▓▒▒░░░░░░▒▓░░░░░░░░▓▒▒▒▒▒▒▒▒▒▓░░░░░▒▓▒▒▒▒▒▒▒▒▒▒▒▓▓░░░░░░░░░▒▒░░░░░▒▒░░░░▒░░▒▒▓░░░░░░░░░▒▒▒░░░░▓▒░░░░░░▓░░░░░▒▓░░░░░▒▒░░░░░░░▒▓▒▒░░░░░░▒▒░░░░░░░░▒▓▒░░░░░░░▒▒░░░░░▒▓▒▒▒▓▓▒▒▒▓▓▒▒▓▓▓▓▓▓▒▒▒▒▒▒▒░░░░░░▒▒▓▒▒▒▒░▒▒▒▓▓▓▒░░░▒▒▒▒▓▒▒░░░░░░
░░░░░▒▓▒▒▓▒░░░░░░▒█▓▒▒▒▒▒▓▒░░░░░░░░░░░▒▓▒▓▓▒▒▒░░░▒▓▒▒▒▒░░░▒▒░░░░░░░▒▓░▒░░░░░░▒▓▒░░░░░░░▒▓░▒▒░░░░░▒▒░░░░░▒▒░▒▒░░░░░░░░░▓░░░░░░░░░░▒▒░░░░░▓░░░░▒░░░▒▒▓▒░░░░░░░░▒▒▒░░░░▒▓░░░░░░▒▒░░░░░▒▒░░░░░▒▓░░░░░░░░▓▒▒▒░░░░░░▒▒░░░░░░░░▒▒░░░░░░░░▒▒░░░░░░▒▒▒░▒▓▒▒▒▓▓▓▒▒▓▓▓▓▒░░▒▒▒▒▓▒░░░░░░▒▒▓▒▒▓▒░░▒▒▓▓▓▒░░░░▒▒▒▒▒▒░░░
