░░░░░░░       ░░░░░░░░░░░░▒▒▒▒▒▒▒▒▒▒▒▒▒▒▒▒▒▒▒▒▒▒▒▒▒▒▒▒▒▒▒▒▒▒▒▒▒▒▒▒▒▒▒▒▒▒▒▒▒▒▒▒▒▒▒▒▒▒▒▒▒▒▒▒▒▒▒▒▒▒▒░▒░▒▒▒░▒▒▒░▒▒▒▒░▒▒░░░▒░▒▒▒▒▒▒▒▒▒▒▒▒▒▒▒▒▒▒▒▒▒▒▒▒▒▒▒▒▒▒▒▒▒▒▒▒▒▒▒▒▒▒▒▒▒▒▒▒▒▒▒▒▒▒▒▒▒▒▒▒▒▒▒▒▒▒▒▒▒▒▒▒▒▒▒▒▒▒▒░▒▒░░░░░░░░░░░░▒▒▒▒▒▒
░░░░░░░         ░░░░░░░░░▒▒▒▒▒▒▒▒▒▒▒▒▒▒▒▒▒▒▒▒▒▒▒▒▒▒▒▒▒▒▒▒▒▒▒▒▒▒▒▒▒▒▒▒▒▒▒▒▒▒▒▒▒▒▒▒▒▒▒▒▒▒▒▒▒▒▒▒▒▒▒▒░▒░░░░░ ░░░░░░   ░░ ▒░▒▒▒▒▒▒▒▒▒▒▒▒▒▒▒▒▒▒▒▒▒▒▒▒▒▒▒▒▒▒▒▒▒▒▒▒▒▒▒▒▒▒▒▒▒▒▒▒▒▒▒▒▒▒▒▒▒▒▒▒▒▒▒▒▒▒▒▒▒▒▒▒▒▒▒▒▒▒▒▒░░▒░░░░░░░░░░░░▒▒▒▒▒▒
░░░░░░░       ░░░░░░░░░░▒▒▒▒▒▒▒▒▒▒▒▒▒▒▒▒▒▒▒▒▒▒▒▒▒▓▒▒▒▓▓▒▓▓▒▓▒▒▒▒▒▒▒▒▒▒▒▒▒▒▒▒▒▒▒▒▒▒▒▒▒▒▒▒▒▒▒▒▒▒▒▒▒▒▒░▒▒▒▒▒░▒▒▒▒▒░▒▒▒░░░▒▒▒▒▒▒▒▒▒▒▒▒▒▒▒▒▒▒▒▒▒▒▒▒▒▒▒▒▒▒▒▒▒▒▒▒▒▒▒▒▒▒▒▒▒▒▒▒▒▒▒▒▒▒▒▒▒▒▒▒▒▒▒▒▒▒▒▒▒▒▒▒▒▒▒▒▒▒▒▒▒▒▒▒░░░░░░░░░░░░▒▒▒▒▒▒
░░░░░░░       ░░░░░░░░░▒▒▒▒▒▒▒▒▒▒▒▒▒▒▒▒▒▒▒▒▒▓▓▓▓▓▓▓▓▓▓▓▓▓▓▓▓▓▓▓▓▓▓▓▓▒▒▒▒▒▒▒▒▒▒▒▒▒▒▒▒▒▒▒▒▒▒▒▒▒▒▒▒▒▒▒▒▒▒▒▒▒░▒▒▒▒▒░▒▒▒▒▒▒▒▒▒▒▒▒▒▒▒▒▒▒▒▒▒▒▒▒▒▒▒▒▒▒▒▒▒▒▒▒▒▒▒▒▒▒▒▒▒▒▒▒▒▒▒▒▒▒▒▒▒▒▒▒▒▒▒▒▒▒▒▒▒▒▒▒▒▒▒▒▒▒▒▒▒▒▒▒▒▒▒▒▒▒░░░░░░░░░░░░▒▒▒▒▒▒
░░░░░░░       ░░░░░░░░▒▒▒▒▒▒▒▒▒▒▒▒▒▒▒▒▒▒▓▓▓▓▓▓▓▓▓▓▓▓▓▓▓▓▓▓▓▓▓▓▓▓▓▓▓▓▓▓▓▓▓▒▓▒▒▒▒▒▒▒▒▒▒▒▒▒▒▒▒▒▒▒▒▒▒▒▒▒▒▒▒▒▒▒▒▒▒▒▒▒▒▒▒▒▒▒▒▒▒▒▒▒▒▒▒▒▒▒▒▒▒▒▒▒▒▒▒▒▒▒▒▒▒▒▒▒▒▒▒▒▒▒▒▒▒▒▒▒▒▒▒▒▒▒▒▒▒▒▒▒▒▒▒▒▒▒▒▒▒▒▒▒▒▒▒▒▒▒▒▒▒▒▒▒▒▒▒▒░▒░░░░░░░░░░░░▒▒▒▒▒▒
░░░░░░░      ░░░░░░░░░▒▒▒▒▒▒▒▒▒▒▒▒▒▒▒▓▓▓▓▓▓▓▓▓▓▓▓▓▓▓▓▓▓▓▓▓▓▓▓▓▓▓▓▓▓▓▓▓▓▓▒▒▓▓▒▒▒▒▒▒▒▒▒▒▒▒▒▒▒▒▒▒▒▒▒▒▒▒▒▒▒▒▒▒▒▒▒▒▒▒▒▒▒▒▒▒▒▒▒▒▒▒▒▒▒▒▒▒▒▒▒▒▒▒▒▒▒▒▒▒▒▒▒▒▒▒▒▒▒▒▒▒▒▒▒▒▒▒▒▒▒▒▒▒▒▒▒▒▒▒▒▒▒▒▒▒▒▒▒▒▒▒▒▒▒▒▒▒▒▒▒▒▒▒▒▒▒▒▒▒░░░░░░░░░░░░▒▒▒▒▒▒
░░░░░░░       ░░░░░░░░░░░░░▒▒▒▒▒▒▒▒▒▒▒▒▒▒▒▒▒▒▒▒▒▒▒▒▒▒▒▒▒▒▒▒▒▒▒▒▒▒▒▒▒▒▒▒▒▒▒▒▒▒▒▒▒▒▒▒▒▒▒▒▒▒▒▒▒▒▒▒▒▒▒▒▒▒▒▒▒▒▒▒▒▒▒▒▒▒▒▒▒▒▒▒▒▒▒▒▒▒▒▒▒▒▒▒▒▒▒▒▒▒▒▒▒▒▒▒▒▒▒▒▒▒▒▒▒▒▒▒▒▒▒▒▒▒▒▒▒▒▒▒▒▒▒▒▒░▒░░░░░░░░░░░░░░░░░░░░░░░░░▒▒▒░░░░░░░░░░░░▒▒▒▒▒▒
░░░░░░░      ░░░░░░░░░      ░░░░░░░░░░░░░░░░░░░░░░░░░░░░░░░░░░░░▒▒▒▒▒▒▒▒▒▒▒▒▒▒▒▒▒▒▒▒▒▒▒▒▒▒▒▒▒▒▒▓▓▓▓▓▓▓▓▓▓▓▓▓▓▓▓▓▓▓▓▓▓▓▓▓▓▓▓▓▓▓▓▓▓▓▓▓▓▓▓▒▒▒▒▒▒▒▒▒▒▒▒▒▒▒▒▒▒▒▒▒▒▒▒▒░░░░░░░░░░░░░░░░░░░░░░░░░░░░░ ░░      ░░▒▒░░░░░░░░░░░░▒▒▒▒▒▒
░░░░░░░░     ░░░░░░░░░   ░░ ░░░░░░░░░░░░░░░░░░░░░░░░░░░░░░░░░░░▒▒▒▒▒▒▒▒▒▒▒▒▒▒▒▒▒▒▒▒▒▒▒▒▒▒▒▒▒▓▓▓▓▓▓▓▓▓▓▓▓▓▓▓▓▒░░░░░░░░░░░░░░░▒▓▓▓▓▓▓▓▓▓▓▓▓▒▒▒▒▒▒▒▒▒▒▒▒▒▒▒▒▒▒▒▒▒▒▒▒▒▒░░░░░░░░░░░░░░░░░░░░░░░░░░░░░░     ░░░░░░░░░░░░░░░░▒▒▒▒▒▒
░░░░░░░░     ░░░░░░░▒░  ░░░░░░░░░░░░░░░░░░░░░░░░░░░░░░░░░░░░░▒▒▒▒▒▒▒▒▒▒▒▒▒▒▒▒▒▒▒▒▒▒▒▒▒▒▒▒▒▓▓▓▓▓▓▓▓▓▓▓▓▓▓▓▒░░░░              ░░░▒▒▓▓▓▓▓▓▓▓▓▓▒▒▒▒▒▒▒▒▒▒▒▒▒▒▒▒▒▒▒▒▒▒▒▒▒░░░░░░░░░░░░░░░░░░░░░░░░░░░░░░░   ░░░▒▒▒░░░░░░░░░░▒▒▒▒▒▒
░░░░░░░░    ░░░░░░░░▒░ ░░░░░░░░░░░░░░░░░░░░░░░░░░░░░░░░░░░░▒▒▒▒▒▒▒▒▒▒▒▒▒▒▒▒▒▒▒▒▒▒▒▒▒▒▒▒▒▓▓▓▓▓▓▓▓▓▓▓▓▒▒▒░░░                  ░░░░░▒▒▓▓▓▓▓▓▓▓▓▒▒▒▒▒▒▒▒▒▒▒▒▒▒▒▒▒▒▒▒▒▒▒▒▒░░░░░░░░░░░░░░░░░░░░░░░░░░░░░░░░ ░░░░░░░░░░░░░░░░▒▒▒▒▒▒
░░░░░░░░     ░░░░░░░▒░░░░░░░░░░░░░░░░░░░░░░░░░░░░░░░░░░░░▒▒▒▒▒▒▒▒▒▒▒▒▒▒▒▒▒▒▒▒▒▒▒▒▒▒▒▒▒▓▓▓▓▓▓▓▓▒▒▒░░░░░░                    ░░░░░░░░░░░▒▒▒▒▓▓▓▓▓▒▒▒▒▒▒▒▒▒▒▒▒▒▒▒▒▒▒▒▒▒▒▒▒░░░░░░░░░░░░░░░░░░░░░░░░░░░░░░░░░░░▒░░░░░░░░░░░▒▒▒▒▒▒
░░░░░░░░    ░░░░░░░▒▒░░░░░░░░░░░░░░░░░░░░░░░░░░░░░░░░░▒▒▒▒▒▒▒▒▒▒▒▒▒▒▒▒▒▒▒▒▒▒▒▒▒▒▒▒▒▓▓▓▓▓▓▓▓▓▒▒▒░░░░░░░░  ░░░ ░░░░░░░░░░░░▒▒▒▒▒▒▒▒▒▒▒▒▒▒▒▒▒▒▒▒▓▓▓▓▓▒▒▒▒▒▒▒▒▒▒▒▒▒▒▒▒▒▒▒▒▒▒▒░░░░░░░░░░░░░░░░░░░░░░░░░░░░░░░░░▒░░░░░░░░░░░▒▒▒▒▒▒
░░░░░░░░    ░░░░░░░▒▒░░░░░░░░░░░░░░░░░░░░░░░░░░░░░░░▒▒▒▒▒▒▒▒▒▒▒▒▒▒▒▒▒▒▒▒▒▒▒▒▒▒▒▒▓▓▓▓▓▒▒▒▒▒▒▒░░░░░░                      ░░░░░░░░░░▒▒▒▒▒▒▒▒▒▒▒▓▓▓▓▓▓▓▓▒▒▒▒▒▒▒▒▒▒▒▒░▒▒▒▒▒▒▒░░░░░░░░░░░░░░░░░░░░░░░░░░░░░░░░░░░░░░░░░░░░░▒▒▒▒▒▒
░░░░░░░░    ░░░░░░░▒▒░░░░░░░░░░░░░░░░░░░░░░░░░░░░░▒▒▒▒▒▒▒▒▒▒▒▒▒▒▒▒▒▒▒▒▒▒▒▒▒▒▒▒▒▒▒░░     ░  ░░░░░░░░ ░░░░░░ ░░░░░░░░░░░░░░░░░░░░░░░░░░░░░░░░░░░░░░░░░░▒▒▒▒▒▒▒▒▒▒▒▒▒▒▒▒▒▒▒▒▒▒░░░░░░░░░░░░░░░░░░░░░░░░░░░░░░░▒░░░░░░░░░░░▒▒▒▒▒▒
░░░░░░░░    ░░░░░░░▒▒░░░░░░░░░░░░░░░░░░░░░░░░░░▒░▒▒▒▒▒▒▒▒▒▒▒▒▒▒▒▒▒▒▒▒▒▒▒▒░░░░  ░   ░░░░░░░░░░░░░░░░░░░░░░░░░░░░░░░░░░░░░░░░░░░░░░░░░░░░░░░░░░░░░░░░░ ░       ░░▒▒▒▒▒▒▒▒▒▒▒▒▒▒░░░░░░░░░░░░░░░░░░░░░░░░░░░░░░░░░░░░░░░░░▒▒▒▒▒▒
░░░░░░░░    ░░░░░░░▒▒░░░░░░░░░░░░░░░░░░░░░░░░▒▒▒▒▒▒▒▒▒▒▒▒▒▒▒▒▒▒▒▒▒▒░░      ░░░░░░░░░░░░░░░░░░░░░░░░░░░░░░░░░░░░░░░░░░░░░░░░░░░░░░░░░░░░░░░░░░░░░░░░░░░░░░░░        ░▒▒▒▒▒▒▒▒▒░▒░░░░░░░░░░░░░░░░░░░░░░░░░░░░░░░░░░░░░░░▒▒▒▒▒▒
░░░░░░░░    ░░░░░░▒▒▒░░░░░░░░░░░░░░░░░░░░░░▒▒▒▒▒▒▒▒▒▒▒▒▒▒▒▒▒▒▒▒░░  ░░░░░░░░░░░░░░░░░░░░░░░░░░░░░░░░░░░░░░░░░▒░▒▒▒▒▒▒▒▒▒▒░░░░░░░░░░░░░░░░░░░░░░░░░░░░░░░░░░░░░░░░░░░   ░░▒▒▒▒▒▒▒▒░░░░░░░░░░░░░░░░░░░░░░░░░░▒░░░░░░░░░░░▒▒▒▒▒▒
░░░░░░░░    ░░░░░░▒▒▒░░░░░░░░░░░░░░░░░░░▒▒▒▒▒▒▒▒▒▒▒▒▒▒▒▒▒▒▒▒░░░░░░  ░░ ░░░░░░░░░░░░░░░░░░░░░░▒▒▒▒▒▒▒▒▓▓▒▒▒▒▒▒██▒▒▒▒▓█▓▒▒▒▒▓█▓▒▒▒▒▓▓▒▒▒▒▒▒▒▒░░░░░░░░░░░░░░░░░░░░░░░░░░░░░░░▒▒▒▒▒▒▒▒░░░░░░░░░░░░░░░░░░░░░░░░░░░░░░░░░░░░▒▒▒▒▒▒
░░░░░░░░    ░░░░░░▒▒▒░░░░░░░░░░░░░░░░░▒▒▒▒▒▒▒▒▒▒▒▒▒▒▒▒▒▒▒▒▒░░░░ ░░░░░░░░░░░░░░░░░░░░░▒▒▒▒▒▓▓▓▒▒█▓▒▒▒▒▒▓▒░░░░▒▒▒░░░░▒▒▒▒░░░▒▒▒░░▒▒▒▒▒▒▒▓▓▒▒▓▓▓▒▒▒▒▒▒░░░░░░░░░░░░░░░░░░░░ ░░░░▒▒▒▒▒▒▒░░░░░░░░░░░░░░░░░░░░░░░░░░░░░░░░░░░▒▒▒▒▒▒
░░░░░░░░    ░░░░░░▒▒▒░░░░░░░░░░░░░░░░▒▒▒▒▒▒▒▒▒▒▒▒▒▒▒▒▒▒▒▒▒░░░ ░░░░░░░░░░░░░░░░░░░▒▒▒▓▓▓▓██▓▓▒▒▒▒▒░░░░░░▒░░░░░░░░░░░░▒░░░░░░░░░░░░░░░░░░░░▒▒▒▒▓▓▓▓█▓▓▒▒▒░░░░░░░░░░░░░░░░░░░░░▒▒▒▒▒▒▒▒▒░░░░░░░░░░░░░░░░░░░░░░░░░░░░░░░░░▒▒▒▒▒▒
░░░░░░░░    ░░░░░░▒▒▒░░░░░░░░░░░░░▒░▒▒▒▒▒▒▒▒▒▒▒▒▒▒▒▒▒▒▒▒▒▒░░ ░░░░░░░░░░░░░░░░░▒▒▓▓▓█▓▓▓▓▒▒▒░░░░░░░░░░░░░░░░░░░░░░░░░░░░░░░░░░░░░░░░░░░░░░░░░░░▒▒▒▒▓▓█▓▓▓▒▒░░░░░░░░░░░░░▒▒░░▒▒▒▒▒▒▒▒▒▒▒▒░░░░░░░░░░░░░░░░░░░░░░░░░░░░░░░▒▒▒▒▒▒
░░░░░░░░    ░░░░░░▒▒▒░░░░░░░░░░░░░▒▒▒▒▒▒▒▒▒▒▒▒▒▒▒▒▒▒▒▒▒▒▒▒▒░░░░░░░░░░░░░░░░░▒▒▓▓██▓▓▒▒▒▒▒░░░░░░░░░░░░░░░▒░░░░░░░▒▒░▒▒▒░░▒░░░░░░░░▒░░░░░░░░░░░░░░░▒▒▒▓▓███▓▒▒░░░░░░░░░▒▒▒▒░▒▓▒▒▒▒▒▒▒▒▒▒▒░░░░░░░░░░░░░░░░░░░░░░░░░░░░░░░▒▒▒▒▒▒
░░░░░░░░    ░░░░░░▒▒▒▒░░░░░░░░░▒▒▒▒▒▒▒▒▒▒▒▒▒▒▒▒▒▒▒▒▒▒▒▒▒▒▒▒▒▒░░░░░░░░░░░░░░▒▒▓▓██▓▒▒▒▒▒░░░░░░░░░░░░░░░░░░▒▒▒▒▒▒▒▒▓▒▓▓▓▓▒▒▒▒▒▒▒▒▒░░░░░░░░▒░░░░░░░░░░▒▒▒▓▓██▓▒▒░░░░░░▒▒▒▒▒▒▓▒▒▒▒▒▒▒▒▒▒▒▒▒▒▒░░░░░░░░░░░░░░░░░░░░░░░░░░░░░▒▒▒▒▒▒
░░░░░░░░   ░░░░░░░▒▒▒▒░░░░░░░░░▒▒▒▒▒▒▒▒▒▒▒▒▒▒▒▒▒▒▒▒▒▒▒▒▒▒▒▒▒▒▒▒▒░░░░░░░░░░▒▒▒▓██▓▓▒▒▒▒▒░░░░░░░░░░░░░▒▒▓▓█▓▓██▓▓████▓███▓▓██▓▓██▓▓▓▓▓▒░░░░░▒▒▒░░░░░▒▒▒▒▓▓██▓▒▒░░░░▒▒▒▓▓▓▒▒▒▒▒▒▒▒▒▒▒▒▒▒▒▒▒▒▒▒░░░░░░░░░░░░░░░▒░░░░░░░░░░░▒▒▒▒▒▒
░░░░░░░░   ░░░░░░░▒▒▒▒░░░░░░▒▒▒▒▒▒▒▒▒▒▒▒▒▒▒▒▒▒▒▒▒▒▒▒▒▒▒▒▒▒▒▒▒▒▒▒▒▒▒▒▒▒▒▒▒▒▒▒▒▓▓███▓▓▒▒▒░░░░░░▒▒░░▒▒▒▒▒▓▓▓████████████████████▓▓███▓▓▒▒░░░▒▒░░░░░▒▒▒▒▓▓▓▓▓▓▒▒▒▒▓▓▓█▓▓▒▒▒▒▒▒▒▒▒▒▒▒▒▒▒▒▒▒▒▒▒▒▒▒▒░░░░░░░░░░░░░░░▒░░░░░░░░░▒▒▒▒▒▒
░░░░░░░░   ░░░░░░░▒▒▒▒░░░░░░▒▒▒▒▒▒▒▒▒▒▒▒▒▒▒▒▒▒▒▒▒▒▒▒▒▒▒▒▒▒▒▒▒▒▓▓▓▓▓▓▓▓▓▓▒▒▒▒▒▒▓▓▓▓█▓▓▓▒▒▒▒▒░░░▒░▒▒▒▒▓▓▓▓▓▓▒▓▓▓█████████████▓▓▒▒▒▒▒▒▒░░▒▒▓▒▒▒▒▒▒▒▓▓▓██▓▓▓▓▓▓█▓▓▓▒▒▓▒▒▒▒▒▒▒▒▒▒▒▒▒▒▒▒▒▒▒▒▒▒▒▒▒▒▒░░░░░░░░░░░░░░░░░░░░░░░░░▒▒▒▒▒▒
░░░░░░░░    ░░░░░░▒▒▒▒░░░░▒▒▒▒▒▒▒▒▒▒▒▒▒▒▒▒▒▒▒▒▒▒▒▒▒▒▒▒▒▒▒▒▒▒▒▓▓▓▓▓▓▓▓▓▓▓▓▓▓▓▓▓▓▓▓▓▓▓▓▓▓▓█▓▓▓▓▒▒▒▒▒▒▒▒▒▓▓▓▒▒▒▒▓████████████▓▒▒▒░░░░░░░░▒▓▓▓▓▓▓▓█▓▓▓▓███▓▓▓▓▓▓▓▓▓▒▒▒▒▒▒▒▒▒▒▒▒▒▒▒▒▒▒▒▒▒▒▒▒▒▒▒▒▒▒▒▒▒░░░░░░░░░░▒▒░░░░░░░░░░▒▒▒▒▒▓
░░░░░░░░   ░░░░░░░▒▒▒▒░░▒▒▒▒▒▒▒▒▒▒▒▒▒▒▒▒▒▒▒▒▒▒▒▒▒▒▒▒▒▒▒▒▒▓▒▓▓▓▓▓▓▓▓▓▓▓▓▓▓▓▓▓▓▓▓▓▓▓████▓▓▓█▓▓█▓▓▓██▓▓▓▓▒▒▒▒▒▒▒▒▓██████████▓▓▒▒░░░░░░░░░▒▓█████████▓▓▓▓▓▓▓▓▓▓▓▓▓▓▒▒▒▒▒▒▒▒▒▒▒▒▒▒▒▒▒▒▒▒▒▒▒▒▒▒▒▒▒▒▒▒▒▒▒░░░░░░░░▒▒▒░░░░░░░░░▒▒▒▒▒▓
░░░░░░░░   ░░░░░░░▒▒▒▒░▒▒▒▒▒▒▒▒▒▒▒▒▒▒▒▒▒▒▒▒▒▒▒▒▒▒▒▒▒▒▒▒▒▒▒▓▓▓▓▓▓▓▓▓▓▓▓▓▓▓▓▓▓▓▓▓▓▓▓██▓██▓▓▓▓█████████▓▓▓▒▒▒▒▒▒▒▓▓█████████▓▓▒▒▒▒░░░░░░░░▒▒▓██████▓▓▓█▓▓▓▓▓▓▓▓▓▓▒▒▒▒▒▒▒▒▒▒▒▒▒▒▒▒▒▒▒▒▒▒▒▒▒▒▒▒▒▒▒▒▒▒▒▒▒▒░░░░░░▒▒▒░░░░░░░░░▒▒▒▒▓▓
░░░░░░░░   ░░░░░░▒▒▒▒░░░░▒▒▒▒▒▒▒▒▒▒▒▒▒▒▒▒▒▒▒▒▒▒▒▒▒▒▒▒▒▒▓▓▓▓▓▓▓▓▓▓▓▓▓▓▓▓▓▓▓▓▓▓▓▓▓▓▓██▓██▓▓▓██████████▒▒▒░░░▒▒▒▓▓██████████▓▓▓▒▒▒▒░░░░░░░░░▒▒▓████▓▓▓██▓▓▓▓▓▓▓▓▓▓▒▒▒▒▒▓▒▒▒▒▒▒▒▒▒▒▒▒▒▒▒▒▒▒▒▒▒▒▒▒▒▒▒▒▒▒▒▒▒░░░▒▒▒▒▒░░░░░░░▒▒▒▒▒▓▓
░░░░░░░░   ░░░░░░░▒▒▒░   ░░▒▒▒▒▒▒▒▒▒▒▒▒▒▒▒▒▒▒▒▒▒▒▒▒▒▒▒▓▓▓▓▓▓▓▓▓▓▓▓▓▓▓▓▓▓▓▓▓▓▓▓▓▓██▓██▓█▓▓▓▓██▓██████▓▒▒░░░▒▒▒▓▓██████████▓▓▓▒▒▒░░░▒░░░░░░▒▓█████▓▓▓█▓▓▓▓▓▓▓▓▓▓▓▒▒▓▓▒▓▓▒▒▒▒▒▒▒▒▒▒▒▒▒▒▒▒▒▒▒▒▒▒▒▒▒▒▒▒▒▒▒░░░░▒▒▒▒▒░░░░░░░▒▒▒▒▓▓▓
░░░░░░░░   ░░░░░░▒▒▒▒░      ░░░░░▒▒▒▒▒▒▒▒▒▒▒▒▒▒▒▒▒▒▒▒▓▓▓▓▓▓▓▓▓▓▓▓▓▓▓▓▓▓▓▓▓▓▓▓▓▓▓▓▓███▓██▓▓▓█████████▓▒▒▒▒▒▒▒▓▓▓██████████████▓▓▒░░▒▒░░░░░░▓█████▓▓▓█▓▓▓▓▓▓▓▓▓▓▓▒▒▒▓▒▓▒▒▒▒▒▒▒▒▒▒▒▒▒▒▒▒▒▒▒▒▒▒▒▒▒▒▒▒▒▒▒▒▒░░░▒▒▒▒▒▒░░░░░░▒▒▒▒▓▓▓
░░░░░░░░   ░░░░░░▒▒▒▒░   ░  ░░ ░░░▒▒▒▒▒▒▒▒▒▒▒▒▒▒▒▒▒▒▓▓▓▓▓▓▓▓▓▓▓▓▓▓▓▓▓▓▓▓▓▓▓▓▓▓▓▓▓▓███▓██▓▓██▓███████▓▒▒▒▒▒▒▒▓▓███████▓▓▓▓▓▒▒▒▒▒▒░░░░░░░░▒▓▓█████▓▓▓█▓▓▓▓▓▓▓▓▓▓▓▒▒▒▓▒▓▓▓▓▒▒▒▒▒▒▒▒▒▒▒▒▒▒▒▒▒▒▒▒▒▒▒▒▒▒▒▒▒▒░░░▒▒▒▒▒▒▒░░░░░▒▒▒▒▓▓▓
░░░░░░░░   ░░░░░░▒▒▒▒░    ░░  ░░░░░░░░░░░░▒▒▒▒▒▒▒▒▒▓▓▓▓▓▓▓▓▓▓▓▓▓▓▓▓▓▓▓▓▓▓▓▓▓▓▓▓█▓███████▓▓▓█▓███████▓▒▒▒▒▒▒▒▒▒▓▓▓▓▓▓▓▓▓▓▒░░▒▒▒▒▒░░░░░░░░▒▒▓█████▓▓▓█▓▓▓▓▓▓▓▓▓▓▓▒▒▓▓▒▓▓▓▓▒▒▒▒▒▒▒▒▒▒▒▒▒▒▒▒▒▒▒▒▒▒▒▒▒▒▒░░░░░░▒▒▒▒▒▒▒░░░░░░▒▒▒▓▓▓
░░░░░░░░   ░░░░░░▒▒▒▒░     ░  ░ ░░ ░░░░░░░░░░░▒▒▒▒▒▒▓▓▓▓▓▓▓▓▓▓▓▓▓▓▓▓▓▓▓▓▓▓▓▓▓▓▓▓███████▓▓▓▓█▓███████▓▒▒▒▒░▒▒▒░░░░  ░▓▓▓▒   ▒▒▒▒▒░░░░░░░░▒▒▓█████▓▓▓█▓▓▓▓▓▓▓▓▓▓▓▒▒▓▓▒▓▓▓▓▓▓▒▒▒▒▒▒▒▒▒▒▒▒▒▒▒▒▒▒▒▒░░░░░░░░░░░▒▒▒▒▒▒▒░░░░░▒▒▒▓▓▓▓
░░░░░░░░   ░░░░░░▒▒▒▒░      ░░  ░░ ░░░░░░░░░░░░░░░░▒▒▓▓▓▓▓▓▓▓▓▓▓▓▓▓▓▓▓▓▓▓▓▓▓▓▓▓▓▓██████▓▓█▓█▓███████▓▒▒▒▒▒▒▒░  ░░░░▒▓      ▒▒▒▒▒░░░░░░░░░▒▓█████▓▓▓█▓▓▓▓▓▓▓▓▓▓▓▒▒▓▓▒▓▓▓▓▓▓▓▓▒▒▒▒▒▒▒▒▒▒▒░░░░░░░░░░░░░░░░░░▒▒▒▒▒▒▒▒░░░░▒▒▒▒▓▓▓
░░░░░░░░   ░░░░░░▒▒▒▒░      ░░  ░░ ░░░░░░░░░░░░░░░░░▒▒▓▓▓▓▓▓▓▓▓▓▓▓▓▓▓▓▓▓▓▒▒▒▒▒▓▓▓▓████▓▓██▓▓▓███████▒▒▒▒▒░▒▒░  ▒░▒▒▒▒      ▒▒▒▒▒░░░░░░░░░▒▓█████▓▓▓██▓▓▓▓▓▓▓▓▓▓▒▒▒▒▒▓▓▓▓▓▓▓▓▓▓▒▒▒▒▒▒▒░░░░░░░░░░░░░░░░░░░░▒▒▒▒▒▒░░░░░░▒▒▒▓▓▓▓
░░░░░░░░   ░░░░░░▒▒▒▒░    ░   ░░ ░░░░░░░░░░░░░░░░░░░░▒▒▒▒▒▒▓▓▓▓▓▓▓▓▓▓▓▓▓▓▒▒▒░░▒▒▓▓███▓▓▓███▓▓███████▒▒▒▒▒░▒▒░       ▒▒▒▒   ▒▒▒▒▒░░░░░░░░░▒▓█████▓▓▓██▓▓▓▓▓▓▓▓▓▓▓▒▓▓▒▓▓▓▓▓▓▓▓▒▒▒▒░ ░░░░░░░▒░░░░░░░░░░░░░░░▒▒▒▒▒▒▒▒░░░░▒▒▒▓▓▓▓
░░░░░░░░   ░░░░░░▒▒▒▒░        ░░ ░  ░░░░░░░░░░░░░░░░░░░░░░░░░░▒▓▓▓▓▓▓▓▓▓▓▓▓▓▒▒▓▓▓▓▓█▓▓█▓███▓▓███████▒▒▒▒▒░▒▒░ ░▒▒▓  ░▒▒▒   ▒▒░▒▒░░░░░░░░░░▒▓████▓▓▓██▓▓▓▓▓▓▓▓▓▓▓▒▓▓▒▓▓▓▒▒▒▒▒▒▒▒▒░ ░░░░░░░▒░░░▒░░░░░░░░░░░▒▒▒▒▒▒▒▒░░░░▒▒▒▓▓▓▓
░░░░░░░░   ░░░░░░▒▒▒▒░      ░    ░  ░░░░░░░░░░░░░░░░░░░░░░░░░░░▒▓▓▓▓▓▓▓▓▓▓▒░░▒░▒▓▓▓▓▓█████▓▓▓███████▓▒▒▒▒░░▒▒▓▓▒▒▓░ ░▒▒▒   ▒▒░▒▒░░░░░░░░░░░▒████▓▓▓██▓▓▓▓▓▓▓▓▓▓▓▒▒▒▒▒▒▒▒▒▒▒▒▒▒▒░░  ░░░░░░▒░░░░░░░░░░░░░░░▒▒▒▒▒▒▒░░░░░▒▒▒▓▓▓▓
░░░░░░░░   ░░░░░░▒▒▒▒░    ░░░░ ░░░░░░ ░░░░░░░░░░░░░░░░░░░░░░░░░░▒▓▓▓▓▓▓▓▓▓▓▒░░▒▒▓▓▓████▓▓▓▓▓▓▓██████▓▒▒▒▒░░▒░  ▓▓░  ▒▒▒▒   ▒▒░▒▒░░░▒░░░░░░▒▓████▓▓▓█▓▓▓▓▓▓▓▓▓▓▓▒░▒▒▒▒▒▒▒▒▒▒▒▒▒▒░░  ░░░░░░▒░░░░░░░░░░░░░░░▒▒▒▒▒▒▒░░░░░▒▒▒▓▓▓▓
░░░░░░░░   ░░░░░░▒▒▒▒░       ░░░░░ ░░ ░░░░░░░░░░░░░░░░░░░░░░░░░░░▒▓▓▓▓▓▓▓▓▓▓▒▒▓▓▓▓▓▓▓▓▓▓█▓▓██▓██▓███▓▒▒▒▒░░▒▒      ░▒▒▒▒   ▒░░▒▒░░░▒░░░░░░▒▓██▓▓▓▓▓▓▓▓▓▓▓▓▓▓▓▒▒▒▒▒▒▒▒▒▒▒▒▒▒▒▒▒▒░░  ░░░░░░░░░░░░░░░░░░░░░░▒▒▒▒▒▒▒░░░░░▒▒▒▓▓▓▓
░░░░░░░░   ░░░░░░▒▒▒▒░  ░░  ░   ░  ░░░░░░░░░░░░░░░░░░░░░░░░░░░░░░▒▒▓▓▓▓▓▓▓▓▒▒▒▒▓▓▒▒▒▒▓▓▓▒▒▓▓▓▓▓▓▓███▓▒▒▒▒░░░▒▒▒░░░▒▒▒▒▒▒▒▒▒▒░░▒▒░░░▒░░░░░░▒▓██▓▓▓▓▓▓▓▓▓▓▓▓▓▓▒▒▒▒▒▒▒▒▒▒▒▒▒▒▒▒▒▒▒▒░  ░░░░░░░░░░░░░░░░░░░░░░▒▒▒▒▒▒░░░░░░▒▒▒▓▓▓▓
░░░░░░░░   ░░░░░░▒▒▒▒░  ░ ░░░░░░░░░░░░░░░░░░░░░░░░░░░░░░░░░░░░░░░░░▒▒▒▒▒▒▒▒▒░▒▒▒▒▒▒▒▒▒▒▒▒▒▒▒▓▓▓▓▓███▓▒▒▒▒▒░▒▒▒▒▒▒▒▒▒▒▒▒▒▒▒▒▒▒▒▒▒░░░▒░░░░░▒▓▓██▓▓▓▓▓▓▓▓▓▓▓▓▓▒▒▒▒▒▒▒▒▒▒▒▒▒▒▒▒▒▒▒▒▒░  ░▒░░░░░░░░░░░░░░░░░░░░▒▒▒▒▒▒░▒░░░░▒▒▒▓▓▓▓
░░░░░░░░   ░░░░░░▒▒▒▒░     ░ ░░░░░░░░░░░░░░░░░░░░░░░░░░░░░░░░░░░░░░░▒▒▒▒▒▒▒▒░▒▒▒▒▒▒▒▒▒▒▒▒▒▒▒▓▓█▓▓██▓▓▒▒▒▒▒▒▒▒▒▒▒▒▒▒▒▒▒░▒▒▒░░░░░░░░▒▒░░░░░░▒▓▓▓▓▓▓▓▓▓▓▓▓▓▓▓▓▒▒▒▒▒▒▒▒▒▒▒▒▒▒▒▒▒▒░▒░░  ░░░░░░░░░░░░░░░░░░░░░░▒▒▒▒▒▒▒░░░░░▒▒▒▓▓▓▓
░░░░░░░░   ░░░░░░░▒▒▒░ ░░░░░░ ░░░░░░░░░░░░░░░░░░░░░░░░░░░░░░░░░░░░░░░▒▒▒▒▒▒▒░▒▒▒▒▒▒▒▒▒▒▒▒▒▒▒▒▓▓▓▓▓▓▓▒▒▒▒▒▒▒▒▒▒▒▒▒▒▒▒▒▒▒▒▒▒▒░░░░▒▒▒▒▒░░  ░░▒▓▓▓▓▒▒▓▓▓▓▓▓▓▓▒▒▒▒▒▒▒▒▒▒▒▒▒▒▒▒▒▒▒▒▒▒░░  ░▒▒▒░░░░░░░░░░░░░░░░░░▒▒▒▒▒▒░░░░░░▒▒▒▓▓▓▓
░░░░░░░░   ░░░░░░░▒▒▒░ ░░░░░░░░░░░░░░░░░░░░░░░░░░░░░░░░░░░░░░░░░░░░░▒▒▒▒▒▒▒▒░▒▒▒▒▒▒▒▒▒▒▒▒▒▒▒▒▒▒▓▓▓▒▒▒▒▒▓▒▒▒▒▒▒▒▒▒▒░░▒▓▒▓▓▓▓▒░░░▒▒▒▒▒░░░ ░▒▒▓▒▒▒▒▒▒▒▓▓▓▓▓▒▒▒▒▒▒▒▒▒▒▒▒▒▒▒▒▒▒▒▒▒░▒▒   ░▒░░░░░░░░░░░░░░░░░░░░▒▒▒▒▒▒░░░░░░▒▒▒▓▓▓▓
░░░░░░░░   ░░░░░░▒▒▒▒░░░░░░░░░░░░░░░░░░░░░░░░░░░░░░░░░░░░░░░░░░░░▒▒▒▒▒▒▒▒▒▒▒░▒▒▒▒▒▒▒▒▒▒▒▒▒▒▒▒▒▓▓▓▓▓▓▓▓▓▒▒▒▒▒▒▒▒▒▒▒░░▒▓▒▓▓▓▒▒▒░░▒▒▒▒▒▒▒░  ░░░░░▒▒▒▒▒▒▒▒▒▒▒▒▒▒▒▒▒▒▒▒▒▒▒▒▒▒▒▒▒▒▒▒░ ░  ░▒░ ░░░░░░▒▒░░░░░░░░░░░▒▒▒▒░░░░░░░▒▒▒▓▓▓▓
░░░░░░░░   ░░░░░░░▒▒▒░░░░░░░░░░░░░░░░░░░░░░░░░░░░░░░░░░░░░░░░░▒▒▒▒▒▒▒▒▒▒▒▒▒▒░▒▒▒▒▒▒▒▒▒▒▒▒▒▒▓▒▓▓▓▓▓▓▓▓▓▒▒▒▒▒▒▒░▒▒▒░░▒▒▒▒▓█▒▒▒▒░░▒▒▒▒▒░░░   ░  ░░░░░░▒▒▒▒▒▒▒▒▒▒▒▒▒▒▒▒▒▒▒▒▒▒▒▒▒▒▒░ ░  ░▒ ░▒▒▒▒▒▒▒▒▒▒▒▒▒▒▒░░░░▒▒▒▒░▒░░░░░▒▒▒▒▓▓▓
░░░░░░░░   ░░░░░░░▒▒▒░░░░░░░░░░░░░░░░░░░░░░░░░░░░░░░░░░░▒▒▒▒▒▒▒▒▒▒▒▒▒▒▒▒▒▒▒▒░▒▒▒▒▒▒▒▒▒▒▓▓▓▓▓▓▓▓▓▓▓▓▒▒▓▒▒▒▒▒▒▒░▒▒▒▒▒▒▒▒▒▒▒▒▒▒▒▒▓▓▓▓▓▒▒░░░░░  ░░░░▒▒▒░▒▒▒▒▒▒▒▒▒▒▒▒▒▒▒▒▒▒▒▒▒▒▒▒▒▒░    ░░ ░▒▒▒▒▒▒▒▒▒▒▒▒▒▒▒░░░▒▒▒▒░░░░░░░░▒▒▒▒▓▓▓
░░░░░░░░   ░░░░░░░▒▒▒░░░░░░░░░░░░░░░░░░░░░░░░░░░▒▒▒▒▒▒▒▒▒▒▒▒▒▒▒▒▒▒▒▒▒▒▒▒▒▒▒▒░▒▒▓▓▓▓▓▓▓▓▓▓▓▓▓▓▓▓▓▓▓▒▒▒▒▒▒▒▒▒▒▒░▒▓▓▒▒▒▒░░░░░▒▒▓▒▒▒▒▒░░░░░  ░░░░░▒░░▒▒▒░▒▓▓▓▓▓▓▓▓▓▓▒▒▓▓▒▒▒▒▒▒▒▒▒▒▒░   ░ ░▒▒▒▒▒▒▒▒▒▒▒▒▒▒▒▒░░░░▒▒▒▒░░░░░░░░▒▒▒▓▓▓
░░░░░░░░   ░░░░░░░▒▒▒░░░░░░░░░░░░░░░░░░▒▒▒▒▒▒▒▒▒▒▒▒▒▒▒▒▒▒▒▒▒▒▒▒▒▒▒▒▒▒▒▒▒▓▓▓▒▒▒▓▓▓▓▓▓▓▓▓▓▓▓▓▓▓▓▓▓▓▓▒▒▒▒▒▒▒▒▒▒▒▒▒▒▒▒▒▒▒▒▒▒▓▒▒▒▒▒▒▒▒▒░░░░░░░ ░░░░░▒░░▒▒░▒▒▒▓▓▓▓▓▓▓▓▓▓▓▓▓▓▓▓▓▓▓▓▒▒▒▒▒   ░▒▒▒▒▒▒▒▒▒▒▒▒▒▒▒▒▒▒░░░▒▒░░░░░░░░░░▒▒▒▓▓▓
░░░░░░░░    ░░░░░░░▒▒░░░░░░░░▒▒▒▒▒▒▒▒▒▒▒▒▒▒▒▒▒▒▒▒▒▒▒▒▒▒▒▒▒▒▒▒▒▒▓▓▓▓▓▓▓▓▓▓▓▓▒▒▒▓▓▓▓▓▓▓▓▓▓▓▓▓▓▓▓▓▓▓▒▒▒▒▒▒▒▒▒▒▒▒▒▒▒▒▒▒▒▒▒▒▒▒▒░░░▒▒▒▒▒░░░░░░▒░░░░░░░░░░░░░░░▒▓▓▓▓▓▓▓▓▓▓▓▓▓▓▓▓▓▓▓▓▓▓▒▒  ░▒▓▓▓▒▓▒▒▒▒▒▒▒▒▒▒▒▒▒░░░▒▒░░░░░░░░░░▒▒▒▓▓▓
░░░░░░░░    ░░░░░░░▒▒░ ░░▒▒▒▒▒▒▒▒▒▒▒▒▒▒▒▒▒▒▒▒▒▒▒▒▒▒▒▒▒▓▒▒▓▓▓▓▓▓▓▓▓▓▓▓▓▓▓▓▓▓▓▒▒▓▓▓▓▓▓▓▓▓▓▓▓█▓▓▓▓▓▓▓▓▓▓▓▓▓▒▓▓▒▒▓▓▓▓▓▓▒▒▒▒▒▒▒▒▒░▒▒▒▒▒░░░░░░░░░░░░░░░░░░░░▒▒░░▒▒▒▒▒▓▓▓▓▓▓▓▓▓▓▓▓▒▒▓▒▒▒  ░▒▒▒▒▒▓▓▓▓▓▓▓▒▒▒▒▒▒▒░░░░▒░░░░░░░░░░▒▒▒▓▓▓
░░░░░░░░    ░░░░░░░░▒░ ░▒▒▒▒▒▒▒▒▒▒▒▒▒▒▒▒▒▒▒▒▒▒▒▒▒▒▒▒▒▒▒▒▓▓▒▒▓▓▓▓▒▒▒▒▒▓▓▓▓▓▓▒▒▒▓▓▓▓▓▓▓▓▓▓▓▓▓▓▓▓▓▓▓▓▓▓▓▓▓▓▓▓▓▓▓▓▓▓▓▓▓▓▓▒▓▒▒▒▒▒▒▒▒▒▒▒▒▒▒▒░░▒▒▒▒░▒▒▒▒▒▒▒░░░░░░░░░░░░░░░░░░░░░░░░░░░░░  ░░░░░░░░░░░░░░░░░░░░░░░░▒░░░░░░░░░░▒▒▒▓▓▓
░░░░░░░░    ░░░░░░░░▒░ ░░░░░░░░░░░▒▒▒▒▒▒▒▒▒▒▒▒▒▒▒▒▒▒▒▒▒▒▒▒▒▒▓▓▓▓▒▒▒▒▒▒▒▒▓▓█▓▒▒▒▒▒▒▒▓▓▓█████▓▓▓▓▓▓▓▓▓▓▓▓████▓▓▓▓▓▓▒░░░░▒▓▓▓▒▒▒▒▓▓▒▒▒▒▓▓▓▓▒▒▒▒▒▒▒▒▒▒▒▒▒▒▒▒▒▒▒▒▒▒▒▒▒▒▒░▒░░░░░▒▒▒▒▒▒░  ░░░▒▒▒▒▒▒▒▒▒░░░░░░░░░░░░▒▒░░░░░░░░░▒▒▒▒▓▓
░░░░░░░      ░░░░░░░░░ ░░░░░  ░░░░░░░▒░░▒░░░▒▒▒▒░░░░░░░▒▒▓▓▒▒▒▒░░▒▒▒▒▒▓▓▓▓▓▓▒▒▒▒▒▒▒▒▓▓▒▓▓▓▓▓██▓▓▒▒▒▓▓▓█████▓▓▓▓▓▓▒▒▒▒▒▓██▓▓▓▓▒▓▓▓▓▓▓▓▓▓▓▓▓▓▓▒▒▒▒▒▒▒▒▒▒▒▒▒▒▒▒░░░░░░░▒▒░ ░ ░░░░░░░░  ░▒▒▒▒▒░░░░░░░░░░░░░░░░░░░░░░░░░░░░░▒▒▒▒▓▓
░░░░░▒░▒░    ░░░░░░░░░░░░░░      ░░░░░▒▒▒▒▒▒▒▒▒▒░░░░░░░▒▒▒▒░░░░░░░░░░▒▒▒▒▓▓▒▒▒▒░░░░░░░▒░░▒▒▒▒▒▒░░░░░░▒▒▓▓▓▓▓▓▓▓▒░░░░░▒▒▓▒▒▒▒▒▒▒▒▒▓▓▓▒▒▒▒▓▒▒▒▒▒▒▒▒▒▒▒▒▒▒▒▒▒▒▒▒▒▒▒▒▒░▒▒▒▒▒▒▒▒▒░░░░░  ░▒▒▒▒▒░░░░░░░░░░░░░░░░░░░░░░░░░░░░░▒▒▒▒▓▓
░░░░ ░░░░    ░░░░░░░░░░░░░░░░░░░░░░░░ ░░░░░░░░░░▒░░░▒▒▒▒▒▒▒░░░   ░░░░▒▒▒▒▒▒▒░░░░░░░░░░░░░▒▒▒▒▒▒▒▒▒▒▒▒▒▒▒▒▒▒▒▒▒▒▒▒▒▒▒▒▒▒▒░░░░░░░▒▒▒▒▒▒▒▒▒▒▒▒▒▒▒░░░░░░▒▒▒▒▒▒▒▒▒░░░░░░░▒▒▒▒▒▒▒▒▒▒░░░   ░░░░▒▒▒░░░░░░░░░░░░░░░░░░░░░░░░░░░▒▒▒▒▓▓
░░░░ ░░░░    ░░░░░░░░░ ░░░░░░░░░░░░░░░░░░░   ░░░░░░░░▒▒▒▒░░░░░░░░▒▒▒▒▒▒▒▒▒▒░░░        ░░░▒▒▒▒▒▒▒░░░░░░▒▒▒▒▒▒▒▒▒▒▒▒▒▒▒▒▒▒░░░░░░░░▒▒▒▒▒▒▒▒▒▒▒░░░░░░░░░▒▒▒▒▒▒▒░░░░░░░░░░░░▒▒▒▒▒░░░░░    ░░░░░░░░░░░░░░░░░░░░░░░░░░░░░░░░░▒▒▒▒▓▓
░░░░ ░░░░      ░░░░░░░░░░░░░░░░░░░░░░░░░░░░░░░░░░░░░░░░░░░░░░░░▒▒▒▒▒▒▒▒▒▒▒▒░░░░       ░░░░▒▒▒▒▒░░░░  ░░▒▒▒▒▒▒▒▒▒▒▒░░░░▒▒▒▒▒▒▒▒▒▒▒░░░░░░░░▒░░░░░  ░░░░▒▒▒▒░░░░░░░░░▒░░▒░░░░░░░░░░░░░░░ ░░░░░░░░░░░░░░░░░░░░░░░░░░░░░░░░▒▒▒▒▒▓
░░░░ ░░░░      ░░░░░░░░░░░░░░░░▒▒▒▒▒▒▒▒▒▒▒▒▒▒▒▒▒▒▒▒▒▒▒▒▒▒▒▒▒▒▒▒▒▒▒▒▒▒▒▒▒▒▒▒▒▒▒▒▒▒▒▒▒▒▒▒▒▒▒▒▒▒▒▒▒▒▒▒▒▒░░░░░░░░░░░░░░░░░░░░░░░░░░░░░░░░░░░░░░░░░░░░░░░░░░░░░░░░░░░░░░░░░░░░░░░░░░░░░░░░░░░░░░░░░░░░░░░░░░░░░░░░░░░░░░░░░▒▒▒▒▒▓
░░░░ ░░░         ░░░░░░░░░░▒▒▒▒▒▒▒▒▒▒▒▒▒▒▒▒▒▒▒▒▒▒▒▒▒▒▒▒▒▒▒▒▒▒▒▒▒▒▒▒▒▒▒▒▒▒▒▒▒▒▒▒▒▒▒▒▒▒▒▒▒▒▒▒▒▒▒▒▒▒▒▒▒▒▒▒▒▒▒▒▒▒▒▒▒▒▒▒▒▒▒▒▒▒▒▒▒▒▒▒▒▒▒▒▒▒▒▒▒▒▒▒▒▒▒▒▒▒▒▒▒▒▒▒░▒▒░▒▒░░░░░░░░░░░░░░░░░░░░░░░░░░░░░░░░░░░░░░░░░░░░░░░░░░░░░░░░░▒▒▒▒▒▓