▓▒▒▒▓▓█▓▓█▓▓▓░░░░░░░░▒▒▒▒▒▓▓▒▒▒▒█▓▒▒▒▒▒▓▓███████████████████████████████▓▓▓█▓▓▓▒▒▒▓█▓▒▒▒░▒▓▓▓▓▓▓▓▓▓▒▓▓▓▓▓▓▓▓▓▓██▒░▒▒▓▓▒▒▒▒▒▒▓▓█▓▓▓▓▓▓▓▓▓▓▓▓▓▓▓▓▓▓▓▓▓▓▓▓▓▓▒▓▒▒▒▒▒▒▓▒░░▒▓▓▒▒░░░▒▒▒▒▒▒▒▒▒▓▓▓▒▒▒▒▒▓▓▓▓▒▒▒▒░▒▒▒▒▒▒▒▒▒█▓▒▓▓▒▓▒▒███
▓▒▒▒▓▓█▓▓█▓▓▓░░░░░░░░▒▒▒▒▒▓▓▒▒▒▒█▓▒▒▒▒▒▓▓████████████▓▓▓▓▓▓▓▓▓██████████▓▓▓█▓▓▓▒▒▒▓█▓▒▒▒░▒▓▓▓▓▓▓▓▓▓▒▓▓▓▓▓▓▓▓▓▓██▒░▒▒▓▓▒▒▒▒▒▒▓▓█▓▓▓▓▓▓▓▓▓▓▒▒▒▒▒▒▒▒▓▓▓▓▓▓▓▓▓▓▓▒▒▒▒▒▓▒░░▒▓▓▒▒▒░░▒▒▒▒▒▒▒▒▒▓▓▓▒▒▒▒▒▓▓▓▓▒▒▒▒░▒▒▒▒▒▒▒▒▒█▓▒▓▓▒▓▒▒███
▓▒▒▒▓▓█▓▒█▓▓▓░░░░░░░░▒▒▒▒▒▓▓▒▒▒▒█▓▒▒▒▒▒▓▓████████▓█▓▓▓▓▓▓▓▓▓▓▓▓▓▓▓██████▓▓▓█▓▓▓▒▒▒▓█▓▓▒▒░▒▓▓▓▓▓▓▓▓▓▒▓▓▓▓▓▓▓▓▓▓██▒░▒▒▓▓▒▒▒▒▒▒▓▓█▓▓▓▓▓▓▓▓▒▒▓▓▓▒▒▓▒▒▒▓▒▓▓▓▓▓▓▓▓▒▒▒▒▒▓▒░░▒▓▓▒▒▒░░▒▒▒▒▒▒▒▒▓▓▓▓▒▒▒▒▒▓▓▓▓▒▒▓▒░▒▒▒▒▒▒▒▒▒█▓▒▓▓▒▓▒▒███
▓▒▒▒▓▓█▓▒█▓▓▓░░░░░░░░▒▒▒▒▒▓█▒▒▒▒█▓▒▒▒▒▒▓▓██████▓▓▓▓▓▓▓▓▓▓▓▓▓▓▓▓▓▓▓▓▓██▓▓▓▓▓█▓▓▓▒▒▒▓█▓▓▒▒░▒▓▓▓▓▓▓▓▓█▒▓▓▓▓▓▓▓▓▓▓██▒░▒▒▓▓▒▒▒▒▒▒▓▓▓▓▓▓▓▓▓▓▓▓▓▓▓▓▒▒▒▒▒▓▓▓▒▒▓▓▓▓▒▒▒▒▓▒▒▓▒░▒▓▓▓▒▒▒░░▒▒▒▒▒▒▒▒▓▓▓▓▒▒▒▒▒▓▓▓█▒▒▓▒░▒▒▒▒▒▒▒▒▒█▓▒▓▓▒▓▒▒███
▓░▒▒▓▓█▓▒█▓▓▓░░░░░░░░▒▒▒▒▒▓▓▒▒▒▒█▓▒▒▒▒▒▓▓████▓▓▓▓▓▓▓▓▓▓▓▓▓▓▓▓▓▓▓▓▓▓▓▓▓▓▓▓▓▓█▓▓▓▒▒▒▓█▓▓▒▒░▒▓▓▓▓▓▓▓▓▓▒▓▓▓▓▓▓▓▓▓▓██▒░▒▒▓▓▒▒▒▒▒▓▓▓▓▓▓▓▓▓▓▓▒▓▓▓▓▓▓▓▓▓▓▓▒▒▒▒▒▒▒▒▒▒▒▒▓▒▒▓▒░▒▓▓▓▒▒▒░░▒▒▒▒▒▒▒▓▓▓▓▓▒▒▒▒▒▓▓▓▓▒▒▓▒░▒▒▒▒▒▒▒▒▒██▒▓▓▒▓▒▒███
▓░▒▒▓▓█▓▓█▓▓▓░░░░░░░░▒▒▒▒▒▓▓▒▒▒▒█▓▒▒▒▒▒▓▓████▓▓▓▓▓▓▓▓▓▓▓▓▓▓▓▓▓▓▓▓▓▓▓▓▓▓▓▓▓▓█▓▓▓▒▒▒▓█▓▓▒▒░▒▓▓▓▓▓▓▓▓█▒▓▓▓▓▓▓▓▓▓▓██▒░▒▒▓▓▒▒▒▒▒▓▓▓▓▓▓▓▓▓▓▓▓▓▓▓▓▓▒▒▒▒▓▓▒▓▓▓▓▒▓▒▒▒▒▒▓▓▒▓▒░▒▓█▓▒▒▒░░▒▒▒▒▒▒▓▓▓▓█▓▒▒▒▒▒▓▓▓█▒▒▓▒░▒▒▒▒▒▒▒▒▒██▒▓▓▒▓▓████
▓░▒▒▓▓█▓▓█▓▓▓░░░░░░░░▒▒▒▒▒▓▓▒▒▒▒█▓▒▒▒▒▒▓▓███▓▓▓▓▓▓▓▓▓▓▓▓▓▓▓▓▓▓▓▓▓▓▓▓▓▓▓▓▓▓▓█▓▓▓▒▒▒▓█▓▓▒▒░▒▓▓▓▓▓▓▓▓█▒▓▓▓▓▓▓▓▓▓▓██▒░▒▒▓▓▒▒▒▒▒▓▓▓▓▓▓▓▓▓▓▓▓▓▓▓▓▓▓▓▒▒▓▓▒▒▓▒▓▓▒▒▓▒▒▒▓▓▒▓▒░▒▓█▓▒▒▒░░▒▒▒▒▓▓▓▓▓▓▓▓▒▒▒▒▒▓▓▓█▒▒▓▒░▒▒▒▒▒▒▒▒▒██▒▓▓▓▓▓████
▓▒▒▒▓▓█▓▒█▓▓▓░░░░░░░░▒▒▒▒▒█▓▒▒▒▒█▓▒▒▒▒▒▓▓███▓▓▓▓▓▓▓▓▓▓▓▓▓▓▓▓▓▓▓▓▓▓▓▓▓▓▓▓▓▓▓█▓▓▓▒▒▒▓█▓▒▒▒░▒▓▓▓▓▓▓█▓█▒▓▓▓▓▓▓▓▓▓▓██▒░▒▒▓▓▒▒▒▒▒▓▓▓▓▓▓▓▓▓▓▓▓▓▓▓▓▓▓▓▓▓▒▓▒▒▒▓▒▓▓▒▓▒▒▒▓▓▓▓▒░▒▓█▓▒▒▒▒░▒▒▓▒▓▓▓▓▓▓█▓▒▒▒▒▒▓▓▓█▒▒▓▒░▒▒▒▒▒▒▒▒▒██▒▒▒▓▒▓▓▓▒▓
▓▒▒▒▓▓█▓▒█▓▓▓░░░░░░░░▒▒▒▒▒▓▓▒▒▒▓█▓▒▒▒▒▒▓▓███▓▓▓▓▓▓▓▓▓▓▓▓▓▓▓▓▓▓▓▓▓▓▓▓▓▓▓▓▓▓▓█▓▓▓▒▒▒▓█▓▒▒▒░▒▓▓▓▓▓▓▓▓▓▒▓▓▓▓▓▓▓▓▓▓██▒▒▒▒▓▓▒▒▒▒▒▓▓▓▓▓▓▓▓▓▓▓▓▓▓▓▓▓▒▓▓▓▒▒▓▓▓▒▒▒▓▓▓▒▒▓▓▓▓▓▒░▒▓██▒▒▒▒░▒▓▓▒▓▓▓▓▓▓█▓▒▒▒▒▒▓█▓█▓▒▓▒▒▒▒▒▒▒▒▒▒▒████▓▓▓▓▓▓▓█
▓▒▒▒▓▓█▓▒█▓▓▓░░░░░░░░▒▒▒▒▒▓▓▒▒▒▒█▓▒▒▒▒▒▓▓█▓█▓▓▓▓▓▓▓▓▓▓▓▒▒▓▒▓▓▓▓▓▓▓▓▓▓▒▓▓▓▓▓█▓▓▓▒▒▒▓█▓▒▒▒░▒▓▓▓▓▓▓▓█▓▒▓▓▓▓▓▓▓▓▓▓██▒▒▒▒██▒▒▒▓▒▓▓▓▓▓▓▓▓▓▓▓▓▓▓▓▒▒▓▒▓▓▓▓▓▓▓▒▓▒▒▒▓▒▒▓▓▓▓▓▒░▒▓██▒▓▒░░▒▓▓▓▓▓▓▓▓▓█▓▒▒▒▒▒▓█▓█▓▒▓▒▒▒▒▒▒▒▒▒▒▒████████████
▓░▒▒▓▓█▓▓█▓▓▓░░░░░░░░░▒▒▒▒▓▓▒▒▒▒█▓▒▒▒▒▒▓▓▓▓▓▓▓▓▓▓▓▓▓▓▓▓▓▓▓▒▓▓▓▓▓▓▓▓▓▓▓▒▒▓▓▓█▓▓▓▒▒▒▓█▓▒▒▒░▒▓▓█▓▓▓▓█▓▒▓▓▓▓▓▓▓▓▓███▒░▒▒▓█▒▒▒▓▒▓▓▓▓▓▓▓▓▓▓▓▓▓▓▓▒▒▒▒▒▓▓▓▓▓▓▓▓▒▒▒▒▒▒▓▓▓▓▓▒░▒▓██▒▓▒▒░▒▓▓▓▓▓▓▓▓▓█▓▒▒▒▒▒▓█▓█▓▒▓▒░▒▒▒▒▒▒▒▒▒████████████
▓▒▒▒▓▓█▓▓█▓▓▓░░░░░░░░▒▒▒▒▒▓█▒▒▒▓█▓▒▒▒▒▒▓▓▓█▓▓▓▓▓▓▓▓▓▓▓▓▓▓▓▓▓▓▓▓▓▓▓▓▓▓▓▓▓▓▓▓█▓▓▓▒▒▒▓█▓▒▒▒▒▒▓▓▓▓▓▓▓█▓▒▓▓▓▓▓▓▓▓▓▓██▒░▒▒██▒▒▒▒▒▓▓▓▓▓▓▓▓▓▓▓▓▓▓▓▓▓▓▓▓▓▓▓▓▓▓▓▓▒▒▒▓▓▒▓▓▓▓▓▒░▒▓██▒▓▒░▒▒▓▓▓▓▓▓▓▓▓██▒▒▒▒▒▓█▓█▓▒▓▒░▒▒▒▒▒▒▒▒▒████████████
▓▒▒▒▓▓█▓▓█▓▓▓░░░░░░░░▒▒▒▒▒▓▓▒▒▒▒█▓▒▒▒▒▒▓▓▓█▓▓▓▓▓▓▓▓▒▓▓▓▓▓▓▓▓▓▓▓▓▓▓▓▓▓▓▓▓▓▓▓█▓▓▓▒▒▒▓█▓▒▒▒▒▓▒▒▒▒▒▒▓▓▓▒▓▓█▓▒▒▒▒░▒▓█▒░▒▒██▒▒▒▒▒▓▓▓▓▓▓▓▓▓▓▓▓▓▓▓▓▓▓▓▓▓▓▓▓▓▓▓▒▓▒▒▓▓▒▓▓▓▓▓▒░▒▓██▒▓▒░░▒▓▓▓▓▓▓▓▓███▒▒▓▒▒▓▓▓█▓▒▓▒░▒▒▒▒▒▒▒▒▒████████████
▓▒▒▒▓▓█▓▓█▓▓▓░░░░░░░░░▒▒▒▒▓█▒▒▒▒█▓▒▒▒▒▒▓▓██▓▓▓▓▓▓▓▓▓▓▓▓▓▓▓▓▓▓▓▓▓▓▓▓▓▓▓▓▓▓▓▓█▓▓▓▒▒▒▓█▓▓▒▒▒▒▒▒▒░░░▒▓▓▒▓▓▓▓▓▒▒▒▒░▒█▒░▒▒▓█▒▒▒▓▒▓▓▓▓▓▓▓▓▓▓▓▓▓▓▓▓▓▓▓▓▓▓▓▓▓▓▓▓▓▓▒▓▓▒▓▓▓▓█▒▒▒▓██▒▓▒░▒▒▓▓▓▓▓▓▓▓███▒▒▒▒▒▓███▓▒▓▒░▒▒▒▒▒▒▒▓▓████████████
▓▒▒▒▓▓█▓▓█▓▓▓░░░░░░░░░▒▒▒▒▓█▒▒▒▓█▓▒▒▒▒▒▓▓█▓▓▓▓▓▓▓▓▓▓▓▓▓▓▓▓▓▓▓▓▓▓▓▓▓▓▓▓▓▓▓▓▓█▓▓▓▒▒▒▓█▓▓▒▒▒▒▒▒▒▒░░░▒▒▒▒▓▓▓▒▒▒▒▒▒▒▓▒▒▒▒▒▒▒▒▒▒▒▓▓▓▓▓▓▓▓▓▓▓▓▓▓▓▓▓▓▓▓▓▓▓▓▓▓▓▓▓▓▓▓▓▒▓▓▓▓█▒▒▒▓██▒▓▒▒▒▒▓▓▓▓▓▓▓▓███▒▒▓▒▒▓▓▓█▓▒▓▒░▒▒▒▒▒▒▒▓▓▓▓▓▓▓▓▓▓▓▓▓▓
▓░▒▒▓▓█▓▓█▓▓▓░░░░░░░░▒▒▒▒▒▓▓▒▒▒▓█▓▒▒▒▒▒▓▓█▓▓▓▓▓▓▓▓▓▓█▓▓▓▓▓▓▓▓▓▓▓▓▓▓▓▓▓▓▓▓▓▓█▓▓▓▒▒▒▓█▓▒▒▒▒▒▒░░░░░░░▒░▒▓▓▓▒▒▒▒░░▒▓▒░▒▒▓█▒▒▒▒▒▓▓▒▓▓▓▓▒▒▓▓▓▓▓▓▓▓▓▓▓▓▓▓▓▓▓▓▒▓▒▓▓▓▒▓▓▓▓█▒░▒▓██▒▓▒▒▒▓▓▓▓▓▓▓▓▓███▓▒▒▒▒▓▓██▓▒▓▒░▒▒▒▒▒▒▒▒▒████████████
▓░▒▒▓▓█▓▓█▓▓▓░░░░░░░░▒▒▒▒▒▓▓▒▒▒▒█▓▒▒▒▒▒▓▓▓▓▓▓▓█▓▓▓▓▓▓▓▓▓▓▓▓▓▓▓▓▓▓▓▓▓▓▓▓▓▓▓▓█▓▓▓▒▒▒▓█▓▓▒▒▒▓▓▒▒░░░░▒▒░░▒▓▓▓▓▒░░▒▓▓░░▒▒▓▒▒▒▒▒▒▓▓▓▓▓▓▓▓▓▓▓▓▓▓▓▓▓▒▒▓▓▒▒▒▒▒▓▓▓▓▓▓▓▒▓▓▓▓█▒░▒▓██▒▓▒▒▒▒▓▓▓▓▓▓▓▓███▓▒▓▒▒▓███▓▒▓▒░▒▒▒▒▒▒▒▒▒████████████
▓▒▒▒▓▓█▓▓█▓▓▓░░░░░░░░▒▒▒▒▒▓▓▒▒▒▓█▓▒▒▒▒▓▓▓▓▓▓▓▓▓▓▓▓▓▓▓▓▓▓▓▓▓▓▓▓▓▓▓▓▓▓▓▓▓▓▓▓▓▓▓▓▓▒▒▒▓█▓▓▒▒▒▓▓▒▒▒▒▒▒▒▒░░▒▒▒▓▒▒▒▒▒█▓░░▒▒▓▒▒▒▒▒▒▓▓▓▓▒▓▓▓▓▓▓▓▓▓▓▓▓▓▓▓▓▓▓▓▓▓▓▓▓▓▓▓▓▓▓▓▓▓█▒░▒▓██▒▓▒▒▒▓▓▓▓▓▓▓▓▓███▒▒▓▒▒▓▓██▓▒▓▒░░░▒▒▓▓▓▓▓████████████
▓▒▒▒▓▓█▓▓█▓▓▓░░░░░░░░▒▒▒▒▒▓▓▒▒▒▒▓▓▒▒▒▒▓▓▓▓▓▓▓▓▓▓▓▓▓▓▓▓▓▓▓▓▓▓▓▓▓▓▓▓▓▓▓▓▓▓▓▓▓▓▓▓▓▒▒▒▓█▓▓▒▒▒▓▓▒▒▒▒▒▒▒▒░▒▒▒▒▒▒▒░░▒▓▓░░▒▒▓▓▒░░▒▒▓▓▓▓▓▓▓▓▓▓▓▓▓▓▓▓▓▓▓▓▓▓▓▓▓▓▓▓▓▓▓▓▓▓▓▓▓▓█▒▒▒▓██▒▓▒▒▒▓▓▓▓▓▓▓▓▓███▓▒▓▒▒▓███▓▒▓▒▒▒▒▒▒▒▓▓▓▓▓▓▓▓▓▓▓▓▓▓▓▓
▓▒▒▒▓▓█▓▓█▓▓▓░░░░░░░░▒▒▒▒▒█▓▒▒▒▒▓▓▒▒▒▓▓▓▓▓▓▓▓▓▓▓▓▓▓▓▓▓▓▓▓▓▓▓▓▓▓▓▓▓▓▓▓▓▓▓▓▓▓▓▓▓▒▒▒▒░░░░░ ░░░░  ░░░ ░░░░               ░▒▒▒▓▓▓▓▓▓▓▓▒▒▒▒▒▒▒▒▒▒▒▒▒▒▒▒▒▒▒▒▒▒▒▒▒▒▒▒▒▒▒▒▒▒▒▒▓██▒▓▒▒▒▓▓▓▓▓▓▓▓▓███▓▒▒▒▒████▓▒▓▒░░░▒▒▒▒▒▒▒▒▒▒▒▒▒▒▒▒▒▒▒
▓▒▒▒▓▓█▓▓█▓▓▓░░░░░░░░▒▒▒▒▒█▓▒▒▒▒▓▓▒▒▓▓▓▓▓▓▓▓▓▓▓▓▓▓▓▓▓▓▓▓▓▓▓▓▓▓▓▓▓▓▓▓▓▓▓▓▓▓▓▓▓▓▓▓▓▓▓▒░▓█████████▓░▒▒▒▒▒░▒██████████▓░░▓▒▒▒▒▓▓▓▓▓▓▓▓▓▓▓▓▓▓▓▓▓▓▓▓▓▓▓▓▓▓▓▓▓▓▓▓▓▓▓▓▓▓▓▓▓▒▓███▒▓▒▒▒▓▓▓▓▓▓▓▓▓███▓▒▓▒▒████▓▒▓▒░░░░░▒▒▓▓▓▓▓▓▓▓▓▓▓▓▓▓▓
▓▒▒▒▓▓█▓▒█▓▓▓░░░░░░░░▒▒▒▒▒▓▓▒▒▒▒███████████████████████████████████████████████████▓░▓█████████▓░▒▓▒▓▓▒░██████████▒░▒▓██▓▓▓▓████████████████████████████████████████████▒▓▒▒▒▓▓▓▓▓▓▓▓▓███▓▒▓▒▒▓███▓▒▓▒░░░░░▒▒▓▓▓▓▓▓▓▓▓▓▓▓▓▓▓
▓▒▒▒▓▓█▓▒█▓▓▓░░░░░░░░▒▒▒▒▒▓▓▒▒▒▓▓▓▓▓▓▓▓▓▓▓▓▓▓▓▓▓▓▓▓▓▓▓▓▓▓▓▓▓▓▓▓▓▓▓▓▓▓▓▓▓▓▓▓▓▓▓▓▓▓▓▓▓▒░▒▓██████▓░░▒▓▒▓▓▓░░▓▓▓▓▓██▓▒░░▓▓▓▓▓▓▓▓▓▓▓▓▓▓▓▓▓▓▓▓▓▓▓▓▓▓▓▓▓▓▓▓▓▓▓▓▓▓▓▓▓▓▓▓▓▓▓▓▓▓▓▓▒▓▒▒▒▓▓▓▓▓▓▓▓▓███▓▒▓▒▒▓███▓▒▓▒░░░▒▒▒▒▓▓▓▓▓▓▓▓▓▓▓▓▓▓▓
▓░▒▒▓▓█▓▒█▓▓▓░░░░░░░░▒▒▒▒▒█▓▓▓██████████████████████████████████████████████████████▓▒         ░░░▒▒▓▓▓▒░         ░▒▓██████████████████████▓██████▓███▓▓▓███▓▓▓▓▓▓▓▓▓▓▓▓▓▓▒▒▒▓▓▓▓▓▓▓▓▓███▓▒▓▒▒▓███▓▒▓▒░░░░▒▒▓▓▓▓▓▓▓▓▓▓▓▓▓▓▓▓
▓▒▒▒▓▓█▓▓█▓▓▓░░░░░░░░▒▒▒▒▒▓▓▒▒▒▒▒▒▒▒▒▒▒▒▒▒▒▒▒▒▒▒▒▒▒▒▒▒▒▒▒▒▒▒▒▒▒▒▒▒▒▒▒▒▒▒▒▒▒▒▒▒▒▒▒▒▒▒▒▒░░      ░░▒▒▒▒▓▓▓▓▓░       ░▒▒▒▒▒▒▒▒▒▒▒▒▒▒▒▒▒▒▒▒▒▒▒▒▒▒▒▒▒▒▒▒▒▒▒▒▒▒▒▒▒▒▒▒▒▒▒▒▒▒▒▒▒▒▒▒▒▒▒▓▓▓▓▓▓▓▓▓███▓▒▓▒▒▓███▓▒▓▒░░░▒▒▒▓▓▓▓█▓▓▓▓▓▓▓▓▓▓▓
▓▒▒▒▓▓█▓▓█▓▓▓░░░░░░░░▒▒▒▒▒▓▓▓▓▓▓▓▓▓▓▓▓▓▓▓▓▓▓▓▓▓▓▓▓▓▓▓▓▓▓▓▓▓▓▓▓▓▓▓▓▓▓▓▓▓▓▓▓▓▓▓▓▓▓▓▓▓▓▓▓▓▒░   ░▒▓▓▓▓▓▒▓▓▓▓▓▓▒░   ░▒▓▓▒▒▒▒▒▓▓▓▓▓▓▓▓▓▓▓▓▓▓▓▓▓▓▓▓▓▓▓▓▓▓▓▓▓▓▓▓▓▓▓▓▓▓▓▓▓▓▓▓▓▓▓▓▓▓▓▓▓▓▓▓▓▓▓▓▓▓███▓▒▓▒▒▓███▓▒▓▒░░░░▒▒▓▓▓▓█▓▒▒▒▒▒▒▒▒▒▓
▓▒▒▒▓▓█▓▓█▓▓▓░░░░░░░░▒▒▒▒▒▓▓▓▓▓████▓███████████▓█████████████████████▓██████████▓██▓██▓▓▒░░░▒▓▓▓▓▓▓▒▓▓▓▓▓▓▓░░▒░▒▓▓▓▓▓▓▓▓▓▓▓▓▓▓▓▓▓▓▓▓▓▓▓▓▓▓▓▓▓▓▓▓▓▓▓▓▓▓▓▓▓▓▓▓▓▓▓▓▓▓▓▓▓▓▓▓▓▓▓▓▓▓▓▓▓▓▓▓▓▓███▓▒▓▒▒████▓▒▓▒░░░▒▒▒▓▓▓▓█▓▒▒▒░░▒▒▓▓▓
▓▒▒▒▓▓█▓▓█▓▓▓░░░░░░░░▒▒▒▒▒▓▓▓▓▓▓█████████████████████████████████▓██████████▓▓▓██▓▓▓▓▓▒░▒███▒░▒▓▓▓▓▒▓▓▓▓▓▒░▓███▒░▒▓▓▓▓▓▓▓▓▓▓▓▓▓▓▓▓▓▓▓▓█▓▓▓▓▓▓▓▓▓▓▓▓▓▓▓▓▓▓▓▓▓▓▓▓▓▓▓▓▓▓▓▓▓▓▓▓▓▓▓▓▓▓▓▓▓▓▓███▓▒▓▒▒████▓▒▓▒░░░▒▒▒▓▓▓▓█▓▒▒▒░░▒▓▓▓▓
▓▒▒▒▓▓█▓▓█▓▓▓░░░░░░░░▒▒▒▒▒▓▓▓▓▓▓▓█▓▓▓▓▓██▓████▓████▓▓█▓▓▓▓██▓██▓█▓▓▓▓▓▓▓▓▓▓▓▓▓▓████▓▓▒░▓██████▒▒▓▓▓▒▓▓▓▓░▒██████▓░▒▓▓▓▓▓▓▓▓▓▓▓▓▓█▓▓▓▓▓▓▓▓▓▓▓█▓▓▓▓▓▓▓▓▓▓▓▓▓▓▓▓▓▓▓▓▓▓▓▓▓▓▓▓▓▓▓▓▓▓▓▓▓▓▓▓▓███▓▒▓▒▒████▓▒▓▒░░░▒▒▒▓▓▓▓█▓▒▒▒░░▒▓▓▓▓
▓░▒▒▓▓█▓▓█▓▓▓░░░░░░░░▒▒▒▒▒▓▓▓▓▓▓▓▓▓▓▓▓▓▓▓▓▓▓▓▓▓▓▓▓▓▓▓▓▓▓▓▓▓▓▓▓▓▓▓▓▓▓▓▓▓▓▓▓▓▓▓▓▓▓▓▓▓▓▒░▒████████▒▒▓▓▒▓▓▓░░▒████████░▒▓▓▓▓▓▓▓▓▓▓▓▓▓▓▓▓▓▓▓▓▓▓▓▓▓▓▓▓▓▓▓▓▓▓▓▓▓▓▓▓▓▓▓▓▓▓▓▓▓▓▓▓▓▓▓▓▓▓▓▓▓▓▓▓▓▓███▓▒▓▒▒████▓▒▓▒░░░▒▒▒▓▓▓▓█▓▒▒▒░░▒▓▓▓▓
▓░▒▒▓▓█▓▓█▓▓▓░░░░░░░░▒▒▒▒▒▓████████████████████████████████████████████████████████▓░        ░▒░░▒▓▒▓▓▒░        ░░░░▓██████████████████████████████▓▓▓███▓▓▓▓▓▓████▓▓▓▓█▓▓▓▓▓▓▓▓▓▓▓▓▓████▓▒▓▒▒████▓▒▓▒░░░▒▒▒▓▓▓▓█▓▒▒▒░░▒▓▓▓▓
▓░▒▒▓▓█▓▒█▓▓▓░░░░░░░░▒▒▒▒▒█▓▒▒▒▒▒▒▒▓▓▓▓▓▓▓▓▓▓▓▓▒▓▓▒▒▓▓▓▓▓▓▓▒▓▓▓▓▒▒▒▓▓▓▓▒▓▓▓▓▒▒▓▓▓▓▓▒░            ▒▓▒▓▓░             ░▒▒▒▒▒▒▒▒▒▒▒▒▒▒▒▒▒▒▒▒▒▒▒▒▒▒▒▒▒▒▒▒▒▒▒▒▒▒▒▒▒▒▒▒▒▒▒▒▒▒▒▓▓▒▒▒▓▓▓▓▓▓▓▓████▓▒▓▒▒████▓▒▓▒░░░░▒▒▓▓▓▓█▓▒▒▒░░▒▓▓▓▓
▓░▒▒▓▓█▓▒█▓▓▓░░░░░░░░▒▒▒▒▒▓▓▒▒▒▒▒▒▒▒▒▒▒▒▒▒▒▒▒▒▒▒▒▒▒▒▒▒▒▒▒▒▒▒▒▒▒▒▒▒▒▒▒▓▓▒▒▒▒▒▒▒▒▒▒▒▒░             ░▒▒▒░░             ░░▒▒▒▒▒▒▒▒▒▒▒▒▒▒▒▒▒▒▒▒▒▒▒▒▒▒▒▒▒▒▒▒▒▒▒▒▒▒▒▒▒▒▒▒▒▒▒▒▒▓▒▓▒░▒▓▓▓▓▓▓▓▓▓███▓▒▓▒▒████▓▒▓▒░░░▒▒▒▓▓▓▓█▓▒▒▒░░▒▓▓▓▓
▓░▒▒▓▓█▓▒█▓▓▓░░░░░░░░▒▒▒▒▒▓▓▒▒▒▒▓█████████████████████████████████████████████████▓▒▒▒░░░░░▒▒▒▒▒▒▒▒▒▒▒▒▒▒▒▒▒▒▒▒▒░░░░▒▒████████████████████▓▓▓▓█▓▓▓█████▓▓▓▓███▓▓▓█▓█████▒▓▒░▒▓▓▓▓▓▓▓▓▓███▓▒▓▒▒████▓▒▓▒░░░▒▒▒▓▓▓▓█▓▒▒▒░░▒▓▓▓▓
▓░▒▒▓▓█▓▒█▓▓▓░░░░░░░░▒▒▒▒▒▓▓▒▒▒▒▓▒▒▒▒▒▒▒▒▒▒▒▒▒▒▒▒▒▒▒▒▒▒▒▒▒▒▒▒▒▒▒▒▒▒▒▒▒▒▒▒▒▒▒▒▒▒▒▒▒▓█▓▓▒▒░▒▓▓█▓▓▓▓▓▓▒▓▓▓▓▓█▓▓▓███▒░▒▒█▓▒▒▒▒▒▒▒▒▒▒▒▒▒▒▒▒▒▒▒▒▒▒▒▒▒▒▒▒▒▒▒▒▒▒▒▒▒▒▒▒▒▒▒▒▒▒▒███▒▓▒░▒▓▓▓▓▓▓▓▓████▓▒▓▒▒▓███▓▒▓▒░░░▒▒▒▓▓▓▓█▓▒▒▒▒░▒▓▓▓▓
▓░▒▒▓▓█▓▒█▓▓▓░░░░░░░░▒▒▒▒▒▓▓▒▒▒▒█▓▒▒▒▒▒▒▒▒▒▒▒▒▒▒▒▒▒▒▒▒▒▒▒▒▒▒▒▒▒▒▒▓▒▓▒▓▓▓▒▒▒▓▒▓▒▒▒▒▓█▓▓▒▒▒▒▓▓▓▓▓▓▓▓▓▒▓▓▓▓▓█▓▓▓███▒░▒▒█▓▒░▒▓▒▒▒▒▒▒▒▒▒▒▒▒▒▒▒▒▒▒▒▒▒▒▒▒▒▒▒▒▒▒▒▒▒▒▒▒▒▒▒▓▒▒▒███▒▓▒░▒▓▓▓▓▓▓▓▓████▓▒▓▒▒████▓▒▓▒░░░▒▒▒▓▓▓▓█▓▒▒▒▒░▒▓▓▓▓
▓░▒▒▓▓▓▓▒█▓▓▓░░░░░░░░▒▒▒▒▒▓▓▒▒▒▒█▓▒▒▒▒▓▓▓▓▓▓▓▓▓▓█▓▓▓▓▓▓▓▓▓▓▓▓▓▓▓▓▓▓▓▓▓▓▓▓▓▓▓▓▓▓▒▒▒▓█▓▓▒▒░▒▓▓▓▓▓▓▓▓█▒▓▓▓▓▓█▓▓▓███▒░▒▒█▓▒░▒▒▒▓▓▓▓▓▓▓▓▓▓▓▓▓▓▓▓▓▓▓▓▓▓▓▓▓▓▓▓▓▓▓▓▓▓▓▓▓▓▓▒▒▒███▒▓▒▒▒▓▓▓▓▓▓▓▓████▓▒▓▒▒████▓▒▓▒░░░▒▒▒▓▓▓▓█▓▒▒▒░░▒▓▓▓▓
▓░▒▒▓▓▓▓▒█▓▓▓░░░░░░░▒▒▒▒▒▒▓▓▒▒▒▒█▓▒▒▒▒▓▓▓▓▓▓▓▓▓▓▓▓▓▓▓▓▓▓▓▓▓▓▓▓▓▓▓▓▓▓▓▓▓▓▓▓▓▓▓▓▓▒▒▒▓█▓▓▒▒░▒▓▓█▓▓▓▓▓▓▒▓▓▓▓▓█▓▓▓███▒░▒▒█▓▒▒▒▒▒▓▓▓▓▓▓▓▓▓▓▓▓▓▓▓▓▓▓▓▓▓▓▓▓▓▓▓▓▓▓▓▓▓▓▓▓▓▓▓▒▒▒███▒▓▒▒▒▓▓▓▓▓▓▓▓████▓▒▓▒▒████▓▒▓▒░░░▒▒▒▓▓▓▓█▓▒▒▒░░▒▓▓▓▓
▓░▒▒▓▓▓▓▒█▓▓▓░░░░░░░░▒▒▒▒▒▓▓▒▒▒▒█▓▒▒▒▒▓▓▓▓▓▓▓▓▓▓▓▓▓▓▓▒▓▓▓▓▓▓▒▒▓▓▒▒▓▓▓▓▓▓▒▓▓▓▓▓▓▒▒▒▓█▓▓▒▒░▒▓▓▓▓▓▓▓▓▓▒▓▓▓▓▓█▓▓▓███▒░▒▒█▓▒▒▒▒▒▓▓▓▓▓▓▓▓▓▓▓▓▓▓▓▓▓▓▓▓▓▒▓▒▒▓▓▓▓▓▓▓▒▓▓▓▓▓▓▒▒▒███▒▓▒▒▒▓▓▓▓▓▓▓▓████▓▒▓▒▒████▓▒▓▒░░░▒▒▒▓▓▓▓█▓▒▒▒▒▒▒▓▓▓▓
▓░▒▒▓▓▓▓▒█▓▓▓░░░░░░░░▒▒▒▒▒▓▓▒▒▒▒█▓▒▒▒▒▒▓▓▓▓▓▓▓▓▓▓▓▓▓▒▓▓▓▓▒▒▒▓▒▓▓▒▓▒▒▓▓▓▓▓▓▓▓▓▓▓▒▒▒▓█▓▓▒▒░▒▓▓▓▓▓▓▓▓▓▒▓▓▓▓▓█▓▓▓███▒░▒▒█▓▒▒▒▒▒▓▓▓▒▓▓▓▓▓▓▓▒▒▓▓▓▓▓▒▒▒▓▓▒▓▒▒▒▓▓▓▓▓▒▓▓▓▓▓▒▒▒███▒▓▒▒▒▓▓▓▓▓▓▓▓████▓▒▓▒▒████▓▒▓▒░░░▒▒▒▓▓▓▓█▓▒▒▒▒▒▒▓▓▓▓
▓░▒▒▓▓▓▓▒█▓▓▓░░░░░░░▒▒▒▒▒▒▓▓▒▒▒▒█▓▒▒▒▒▒▓▓▓▓▓▓▓▓▓▓█▓▓▓▓▓▓▓▒▓▓▓▓▓▓▓▓▓▓▓▓▓▓▓▓▓▓▓▓▓▒▒▒▓█▓▓▒▒▒▒▓▓▓▓▓▓▓▓█▒▓▓▓▓▓█▓▓▓███▒░▒▒█▓▒▒▒▒▒▓▓▒▓▓▓▓▓▓▓▓▓▓▓▓▓▒▓▓▓▓▓▓▓▓▓▓▓▓▓▓▓▓▒▒▓▓▓▓▒▒▒███▒▓▒▒▒▓▓▓▓▓▓▓▓████▓▒▓▒▒▓███▓▒▓▒░░░▒▒▒▓▓▓▓█▓▒▒▒▒░▒▓▓▓▓
▓░▒▒▓▓▓▓▒█▓▓▓░░░░░░░▒▒▒▒▒▒▓▓▒▒▒▒█▓▒▒▒▒▒▓▓▓▓▓▓▓█████████▓█▓▓▓▓▓▓▓▓▓▓▓▓▓▓▓▓▓▓▓▓▓▓▒▒▒▓█▓▓▒▒▒▒▓▓▓▓▓▓▓▓█▒▓▓▓▓▓█▓▓▓███▒░▒▒█▓▒▒▒▓▒▒▓▓▓▓▓▓▓██▓▓▓▓▓▓▓▓▓▓▓▓▓▓▓▓▓▓▓▓▓▓▓▓▒▓▓▓█▒▒▒███▒▓▒▒▒▓▓▓▓▓▓▓▓████▓▒▓▒▒▓███▓▒▓▒░░░▒▒▒▓▓▓▓█▓▒▒▒▒▒▒▓▓▓▓
▓░▒▒▓▓▓▓▒█▓▓▓░░░░░░░░▒▒▒▒▒▓▓▒▒▒▒█▓▒▒▒▒▒▓▓▓▓▓▓▓███████▓███▓▓▓▓▓▓▓▓▓▓▓▓▓▓▓▓▓▓▓▓▓▓▒▒▒▓█▓▓▒▒▒▒▓▓▓▓▓▓▓▓█▒▓▓▓▓▓█▓▓▓███▒░▒▒█▓▒▒▒▓▒▓▓▓▓▓▓▓█▓▓████▓▓▓▓▓▓▓▓▓▓▓▓▓▓▓▓▓▓▓▓▓▓▓▓█▒▒▒███▒▓▒▒▒▓▓▓▓▓▓▓▓████▓▒▓▒▒████▓▒▓▒░░░▒▒▒▓▓▓▓█▓▒▒▒▒▒▒▓▓▓▓
▓░▒▒▓▓▓▓▒█▓▓▓░░░░░░░░▒▒▒▒▒▓▓▒▒▒▒█▓▒▒▒▒▒▓▓▓▓▓█████████▓███▓▓▓▓▓█▓▓▓▓▓▓▓▓▓▓▓▓▓▓▓▓▒▒▒▓█▓▓▒▒▒▒▓▓▓▓▓▓▓▓▓▒▓▓▓▓▓█▓▓▓███▒░▒▒█▓▒▒▒▓▒▓▓▓▓▓█▓█▓▓▓▓▓▓▓▓▓▓▓▓▓▓▓▓▓▓▓▓▓▓▓▓▓▓▓▓▓▓█▒▒▒███▒▓▒▒▒▓▓▓▓▓▓▓▓▓███▓▒▓▒▒████▓▒▓▒░░░▒▒▒▓▓▓▓█▓▒▒▒▒▒▒▓▓▓▓
▓░▒▒▓▓▓▓▒█▓▓▓░░░░░░░░▒▒▒▒▒▓▓▒▒▒▒█▓▒▒▒▒▒▓▓▓█▓█████████▓██▓█▓▓▓▓▓▓▓▓▓▓▓▒▓▓▓▓▓▓▓▓▓▒▒▒▓█▓▓▒▒▒▒▓▓▓▓▓▓▓▓▓▒▓▓▓▓▓█▓▓▓███▒░▒▒█▓▒▒▒▓▒▓▓▓▓▓▓▓▓▓█▓▓▓▓▓█▓▓▓▓▓▓▓▓▓▓▓▓▓▓▓▓▓▓▓▓▓▓█▒▒▒███▒▓▒▒▒▓▓▓▓▓▓▓▓▓███▓▒▓▒▒████▓▒▓▒░░░▒▒▒▓▓▓▓█▓▒▒▒▒▒▒▓▓▓▓
▓░▒▒▓▓▓▓▒█▓▓▓░░░░░░░░▒▒▒▒▒▓▓▒▒▒▒█▓▒▒▒▒▒▓▓▓▓▓▓██▓██▓██████▓▓▓▓▓▓▓▓▓▓▓▓▓▒▓▓▓▓▓▓▓▓▒▒▒▓█▓▓▒▒░▒▓▓█▓▓▓▓▓▓▒▓▓▓▓▓█▓▓▓███▒░▒▒█▓▒▒▒▓▒▓▓▓█▓▓█▓▓▓▓▓▓█▓▓▓█▓▓▓▓▓▓▓▓▓▓▓▒▒▓▓▓▓▓▓▓▓▒▒▒███▒▓▒▒▒▓▓▓▓▓▓▓▓▓███▓▒▓▒▒████▓▒▓▒░░░▒▒▒▓▓▓▓█▓▒▒▒▒▒▒▓▓▓▓
▓░▒▒▓▓▓▓▒█▓▓▓░░░░░░░▒▒▒▒▒▒▓▓▒▒▒▒█▓▒▒▒▒▒▓▓▓▓▓█████▓▓███████▓▓█▓█▓▓▓▓▓▓▓▓▒▓▓▓▓▓▓▓▒▒▒▓██▓▒▒▒▒▓▓█▓▓▓▓▓▓▒▓▓▓▓▓█▓▓▓███▒▒▒▒█▓▒▒▒▓▒▓▓▓▓▓█▓▓▓▓▓▓▓▓██▓▓▓▓▓▓▓▓▓▓▓▓▓▓▒▓▓▓▓▓▓▓█▒▒▒███▒▓▒▒▒▓▓▓▓▓▓▓▓▓███▓▒▓▒▒████▓▒▓▒░░░▒▒▒▓▓▓▓█▓▒▒▒▒▒▒▓▓▓▓
▓░▒▒▓▓▓▓▒█▓▓▓░░░░░░░░▒▒▒▒▒▓▓▒▒▒▒█▓▒▒▒▒▒▓▓▓▓▓█████▓▓██▓███▓▓▓▓▓█▓▓▓▓▓▓█▓▒▓▓▓▓▓▓▓▒▒▒▓█▓▓▒▒▒▒▓▓▓▓▓▓▓▓▓▒▓▓▓▓▓█▓▓▓███▒▒▒▒█▓▒▒▒▓▒▓▓▓▓██▓▓▓▓▓▓▓▓██▓▓▓▓▓▓▓▓▓▓▓▓▓█▓▒▓▓▓▓▓▓█▒▒▒███▒▓▒▒▒▓▓▓▓▓▓▓▓▓███▓▒▓▒▒████▓▒▓▒░░▒▒▒▒▓▓▓▓█▓▒▒▒▒▒▒▓▓▓▓
▓░▒▒▓▓▓▓▒█▓▓▓░░░░░░░▒▒▒▒▒▒▓▓▒▒▒▒█▓▒▒▒▒▒▓▓▓▓██████████████▓▓█▓▓█▓▓▓▓▓▓█▓▒▒▓▓▓▓▓▓▒▒▒▓█▓▓▒▒▒▒▓▓▓▓▓▓▓▓▓▒▓▓▓▓▓█▓▓▓███▒▒▒▒█▓▒▒▒▓▒▓▓▓▓███▓██▓▓▓████▓▓▓▓▓▓▓▓▓▓▓▓█▓▒▓▓▓▓▓▓█▒▒▒███▒▓▒▒▒▓▓▓▓▓▓▓▓▓███▓▒▓▒▒████▓▒▓▒░░▒▒▒▒▓▓▓▓█▓▒▒▒▒▒▒▓▓▓▓
▓░▒▒▓▓▓▓▒█▓▓▓░░░░░░░▒▒▒▒▒▒▓▓▒▒▒▒█▓▒▒▒▒▒▓▓▓▓██████▓▓█████▓█▓▓▓▓▓█▓▓▓▓▓█▓▒▒▓▓▓▓▓▓▒▒▒▓█▓▓▒▒▒▒▓▓▓▓▓▓▓▓▓▒▓▓▓▓▓█▓▓▓███▒▒▒▒█▓▒▒▒▒▒▓▓▓▓███▓█▓▓▓▓██▓▓▓▓▓▓▓▓▓▓▓▓▓▓█▓▒▓▓▓▓▓▓▓▒▒▒███▒▓▒▒▒▓▓▓▓▓▓▓▓▓███▓▒▓▒▒████▓▒▓▒░░▒▒▒▒▓▓▓▓█▓▒▒▒▒▒▒▓▓▓▓
▓░▒▒▓▓▓▓▒█▒▓▓░░░░░░░░░▒▒▒▒▓▓▒▒▒▒█▓▒▒▒▒▒▓▓▓▓▓████▓▓▓████▓▓▓▓▓█▓▓▓▓▓▓▓▓█▓▒▒▓▓▓▓▓▓▒▒▒▓█▓▓▒▒▒▒▓▓▓▓▓▓▓▓▓▒▓▓▓▓▓█▓▓▓███▒▒▒▒█▓▒▒▒▒▒▓▓▓▓▓█▓▓▓▓▓▓▓██▓▓█▓▓▓▓▓▓▓▓▓▓▓█▓▒▓▓▓▓▓▓█▒▒▒███▒▓▒▒▒▓▓▓▓▓▓▓▓▓███▓▒▓▒▒▓███▓▒▓▒░░▒▒▒▒▓▓▓▓█▓▒▒▒▒▒▒▓▓▓▓
▓░▒▒▓▓▓▓▒█▒▓▓░░░░░░░▒▒▒▒▒▒▓▓▒▒▒▒▓▓▒▒▒▒▒▓▓▓▓▓███▓▓█▓██▓█▓█▓▓▓▓▓██▓█▓▓▓█▓▒▓▓▓▓▓▓▓▒▒▒▓█▓▓▒▒▒▒▓▓▓▓▓▓▓▓▓▒▓▓▓▓▓█▓▓▓███▒▒▒▒█▓▒▒▒▓▒▓▓▓▓▓██▓▓▓▓▓▓██▓█▓▓▓▓▓▓▓▓▓▓▓▓█▒▒▓▓▓▓▓▓█▒▒▒███▒▓▒▒▒▓▓▓▓▓▓▓▓▓███▓▒▓▒▒▓███▓▒▓▒░░▒▒▒▒▓▓▓▓█▓▒▒▒▒▒▒▓▓▓▓
▓░▒▒▓▓▓▓▒█▓▓▓░░░░░░░░▒▒▒▒▒▓▓▒▒▒▒▓▓▒▒▒▒▒▓▓▓▓▓▓██▓▓█▓██▓███▓▓██▓▓▓▓▓▓▓▓▓▒▓▓▓▓▓▓▓▓▒▒▒▓█▓▓▒▒▒▒▓▓▓▓▓▓▓▓▓▒▓▓▓▓▓█▓▓▓███▒▒▒▒█▓▒▒▒▓▒▓▓▓█▓▓█▓▓▓▓▓▓████▓▓▓▓▓▓▓▓▓▓▓▓▓▒▓▓▓▓▓▓▓█▒▒▒███▒▓▒▒▒▓▓▓▓▓▓▓▓████▓▒▓▒▒████▓▒▓▒░░▒▒▒▒▓▓▓▓█▓▒▒▒▒▒▒▓▓▓▓
▓░▒▒▓▒▓▓▒█▒▓▓░░░░░░░▒▒▒▒▒▒▓▓▒▒▒▒▓▓▒▒▒▒▒▓▓▓▓▓▓▓█▓▓█▓██████▓████▓█▓█▓▓▓▒▓▓▓▓▓▓▓▓▓▒▒▒▓█▓▓▒▒▒▒▓▓█▓▓▓▓▓▓▒▓▓▓▓▓█▓▓▓███▒▒▒▒█▓▒▒▒▓▒▓▓▓▓▓▓▓▓▓▓▓▓▓█████▓▓█▓▓▓▓▓▓▓▒▒▓▓▓▓▓▓▓▓█▒▒▒███▒▓▒▒▒▓▓▓▓▓▓▓▓████▓▒▓▒▒████▓▒▓▒░░▒▒▒▒▓▓▓▓█▓▒▒▒▒▒▒▓▓▓▓
▓░▒▒▓▓▓▓▒▓▒▓▒░░░░░░░░▒▒▒▒▒▓▓▒▒▒▒▓▓▒▒▒▒▒▓▓▓▓▓▓▓▓▓▓▓▓██████▓█▓██▓█▓█▓▒▒▓▓▓▓▓▓▓▓▓▓▒▒▒▓█▓▓▒▒▒▒▓▓█▓▓▓▓▓▓▒▓▓▓▓▓█▓▓▓███▒▒▒▒█▓▒▒▒▓▒▓▓▓▓▓▓▓▓▓▓▓▓▓█████▓▓▓▓▓▓▓▓▓▒▒▓▓▓▓▓▓▓▓▓█▒▒▒███▒▓▒▒▒▓▓▓▓▓▓▓▓████▓▒▓▒▒████▓▒▓▒░░▒▒▒▒▓▓▓▓█▓▒▒▒▒▒▒▓▓▓▓
▓░▒▒▓▒▓▓▒▓▒▓▒░░░░░░░░▒▒▒▒▒▓▓▒▒▒▒▓▓▒▒▒▒▒▓▓▓▓▓▓▓▓▓▓▓▓▓██████▓███▓▓▒▒▒▓▓▓▓▓▓▓▓▓▓▓▓▒▒▒▓█▓▓▒▒▒▒▓▓▓▓▓▓▓▓▓▒▓▓▓▓▓█▓▓▓███▒▒▒▒█▓▒▒▒▓▒▓▓▓▓▓▓▓▓▓▓▓▓▓██████▓▓▓▓▓▓▒▒▓▓▓▓▓▓▓▓▓▓▓█▒▒▒███▒▓▒▒▒▓▓▓▓▓▓▓▓▓███▓▒▓▒▒████▓▒▓▒░░▒▒▒▒▓▓▓▓█▓▒▒▒▒▒▒▓▓▓▓
▓░▒▒▓▒▓▓▒▓▒▓▒░░░░░░░░▒▒▒▒▒▓▓▒▒▒▒▓▓▒▒▒▒▒▓▓▓▓▓▓▓▓▓▓▓▓▓▓▓▓▓▓▓▓▓▓▒▒▓▓▓▓▓▓▓▓▓▓▓▓▓▓▓▓▒▒▒▓█▓▓▒▒▒▒▓▓▓▓▓▓▓▓▓▒▓▓▓▓▓█▓▓▓███▒▒▒▒█▓▒▒▒▓▒▓▓▓▓▓▓▓▓▓▓▓▓▓▓▓▓▓▓▓▓▓▒▒▓▓▓▓▓▓▓▓▓▓▓▓▓▓▓█▒▒▒███▒▓▒▒▒▓▓▓▓▓▓▓▓▓███▓▒▓▒▒████▓▒▓▒░░▒▒▒▒▓▓▓▓█▓▒▒▒▒▒▒▓▓▓▓
▒░▒▒▓▒▓▓▒▓▒▒▒░░░░░░░░▒▒▒▒▒▓▓▒▒▒▒▓▓▒▒▒▒▒▓▓▓▓▓▓▓▓▓▓▓▓▓▓▓▓▓▓▓▓▓▓▓▓▓▓▓▓▓▓▓▓▓▓▒▓▓▓▓▓▒▒▒▓█▓▓▒▒▒▒▓▓▓▓▓▓▓▓▓▒▓▓▓▓▓█▓▓▓███▒▒▒▒█▓▒▒▒▓▒▓▓▓▒▓▓▓▓▓▓▓▓▓▓▓▓▓▓▓▓▓▓▓▓▓▓▓▓▓▓▓▓▓▒▓▓▓▓█▒▒▒███▒▓▒▒▒▓▓▓▓▓▓▓▓▓███▓▒▓▒▒████▓▒▓▒░░▒▒▒▒▓▓▓▓█▓▒▒▒▒▒▒▓▓▓▓
▒░▒▒▓▒▓▓▒▓▒▒▒░░░░░░░░▒▒▒▒▒▓▓▒▒▒▒▓▒▒▒▒▒▒▓▓▓▓▓▓▓▓▓▓▓▓▓▓▓▓▓▓▓▓▓▓▓▓▓▓▓▓▒▓▓▓▓▒▓▓▓▓▓▓▒▒▒▓█▓▓▒▒▒▒▓▓▓▓▓█▓▓▓▒▓▓▓▓▓█▓▓▓███▒▒▒▒█▓▒▒▒▒▒▓▓▒▒▓▓▓▓▓▓▓▓▓▓▓▓▓▓▓▓▓▓▓▓▓▓▓▒▓▓▓▓▒▓▓▓▓▓█▒▒▒███▒▓▒▒▒▓▓▓▓▓▓▓▓▓███▓▒▓▒▒████▓▒▓▒░░▒▒▒▒▓▓▓▓█▓▒▒▒▒▒▒▓▓▓▓
▒░▒▒▓▒▓▒▒▓▒▒▒░░░░░░░░▒▒▒▒▒▓▓▒▒▒▒▓▒▒▒▒▒▒▓▓▓▓▓▓▓▓▓▓▓▓▓▓▓▓▓▓▓▓▓▓▓▓▓▓▓▓▓▓▓▓▒▓▓▓▓▓▓▓▒▒▒██▓▓▒▒▒▒▓▓▓▓▓▓▓▓█▒▓▓▓▓▓█▓▓▓███▒▒▒▒█▓▒▒▒▒▒▓▓▓▓▓▓▓▓▓▓▓▓▓▓▓▓▓▓▓▓▓▓▓▓▓▓▓▓▓▓▓▓▓▓▓▓▓▓█▒▒▒███▒▓▒▒▒▓▓▓▓▓▓▓▓████▓▒▓▒▒████▓▒▓▒░░▒▒▒▒▓▓▓▓█▓▒▒▒▒▒▒▓█▓▓
▒░▒▒▒▒▓▒▒▓▒▒▒░░░░░░░░▒▒▒▒▒▓▒▒▒▒▒▓▒▒▒▒▒▓▓▓▓▓▓▓▓▓▓▓▓▓▓▓▓▓▓▓▓▓▓▓▓▓▓▓▓▓▓▓▓▓▓▓▓▓▓▓▓▓▒▒▒██▓▓▒▒▒▒▓▓▓▓▓▓▓▓▓▒▓▓▓▓▓█▓▓▓███▒▒▒▒█▓▒▒▒▒▒▓▓▓▓▓▓▓▓▓▓▓▓▓▓▓▓▓▓▓▓▓▓▓▓▓▓▓▓▓▓▓▓▓▓▓▓▓▓█▒▒▒███▒▓▒▒▒▓▓▓▓▓▓▓▓████▓▒▓▒▒████▓▒▓▒░▒▒▒▒▒▓▓▓▓█▓▒▒▒▒▒▒▓█▓▓
▒░▒▒▒▒▓▒▒▓▒▒▒░░░░░░░▒▒▒▒▒▒▒▒▒▒▒▒▓▒▒▒▓▓▓▓██████████████████████████████████████▓▒▒▒██▓▓▒▒▒▒▓▓█▓▓▓▓▓▓▒▓▓▓▓▓█▓▓▓▓██▒▒▒▒█▓▒▒▒▓▓████████████████████████████████████▓██▒▒▒███▒▓▒▒▒▓▓▓▓▓▓▓▓▓███▓▒▓▒▒████▓▒▓▒░▒▒▒▒▒▓▓▓▓█▓▒▒▒▒▓▓▓▓▓▓
▒░▒▒▒▒▒▒▒▓▒▒▒░░░░░░░░▒▒▒▒▒▒▒▒▒▒▒▓▒▒▒▒▒▒▒▒▒▒▒▒▒▒▒▒▒▒▒▒▒▒▒▒▒▒▒▒▒▒▒▒▒▒▒▒▒▒▒▒▒▒▒▒▒▒▒▒▒███▓▒▒▒▒▓▓▓▓▓▓▓▓▓▒▓▓▓▓▓█▓▓▓▓██▒░▒▒█▓▒▒▒▒▒▒▒▒▒▒▒▒▒▒▒▒▒▒▒▒▒▒▒▒▒▒▒▒▒▒▒▒▒▒▒▒▒▒▒▒▒▒▒▒▒▒▒███▒▓▒▒▒▓▓▓▓▓▓▓▓████▓▒▓▒▒████▓▒▓▒░░▒▒▒▒▓▓▓▓█▓▓▓████████
▒░▒▒▒▒▒▒▒▓▒▒▒░░░░░░░░▒▒▒▒▒▒▒▒▒▒▒▓▓▓▓▓▓▓▓▓▓██████████████████████▓▓█████████████▓▓▓███▓▒▒▒▒▓▓▓▓▓▓▓▓▓▒▓▓▓▓▓█▓▓▓▓██▒░▒▒▓▓▓▓▓▓█▓▓█▓▓██████████████████▓▓▓▓██▓▓▓▓█████▓▓▓▓███▓▓▒▒▒▓▓▓▓▓▓▓▓████▓▒▓▒▒████▓▒▓▒░░▒▒▒▒▓▓▓▓▓▓▒▒▒▒▒▒▒▒▒▒