▓▓▓▓▓▓▓▓▓▓▓▓▓▓▓▓▓▓▓▓▓▓▓▓▓▓▓▓▓▓▓▓▓▓███▓▓▓▓▓████▓█▓▓███████████████████▓▓▒▒▒▒░▒▓██████▓▓▓▓▓▓▓███████▓▓▓▓█████▓▓▓▓▓▓▓▓▓██████████████████▓▓▓▓██████▓▒▓███████████████████████████████████████████████████████████████████▓▓▓▓▓▓
▓▓▓▓▓▓▓▓▓▓▓▓▓▓▓▓▓▓▓▓▓▓▓▓▓▓▓▓▓▓▓▓█▓▓▓█▓██▓█████▓██████████████████████▓▓▒▒▒▒░▒▓█████▓▓▓▓▓▓▓▓███████▓▓▓▓█████▓▒▓▓▓▓▓▓▓▓█████████████████▓▓▓▓██████▓▒▓████████████████████████████████████████████████████████████████████▓▓▓▓▓
▓▓▓▓▓▓▓▓▓▓▓▓▓▓▓▓▓▓▓▓▓▓▓▓▓▓▓▓█▓▓█▓▓█████▓█████████████████████████████▓▓▒▒▒▒░▒▓█████▓▓▓▓▓▒▒▓▓█▓▓███▓▓▓▓▓▓███▓▒▓▓▓▓▓█▓▓██▓▓█████████████▓▓▓▓██████▓▒▓████████████████████████████████████████████████████████████████████▓▓▓▓▓
▓▓▓▓▓▓▓▓▓▓▓▓▓▓▓▓▓▓▓▓▓▓▓▓▓▓█▓▓▓██▓█▓█▓████████████████████████████████▓▓▒▒▒▒░▒▓█████▓▓▓▓▓▒▒▓▓█▓▓███▓▓▓▓▓▓▓██▓▒▓▓▓▓▓▓▓▓▓▓▓▓▓█████▓▓▓▓███▓▓▓▓██████▓▒▓████████████████████████████████████████████████████████████████████▓▓▓▓▓
▓▓▓▓▓▓▓▓▓▓▓▓▓▓▓▓▓▓▓▓▓▓▓▓█▓██▓██▓▓▓▓██▓███████████████████████████████▓▓▒▒▒▒░▒▓█████▓▓▓▓▓▒▒▒▓█▓▓███▓▓▓▓▓▓▓██▓▒▓▓▓▓▓▓▓▓▓▓▓▓▓▓██▓▓▓▓▓▓▓█▓▓▓▓▓██████▓▒▓███████████████████████████████████████████████████████████████████▓▓▓▓▓▓
▓▓▓▓▓▓▓▓▓▓▓▓▓▓▓▓▓▓▓▓▓▓▓█▓▓▓█▓▓▓▓▓▓█▓▓█████████████████████████████████▓▒▒▒▒░▒▓████▓▓▓▓▓▓▒▒▓▓▓▓▓▓██▓▓▓▓▓▓▓██▒▒▓▓▓▓▓▓▓▓▓▓▒▓▓▓▓▓▓▓▓▓▓▓▓▓▓▓▓▓▓▓█████▓▒▓███████████████████████████████████████████████████████████████████▓▓▓▓▓▓
▓▓▓▓▓▓▓▓▓▓▓▓▓▓▓▓▓▓▓▓▓▓▓█▓███▓████▓████████████████████████████████████▓▒▒▒▒░▒▓████▓▒▓▓▓▓▒▒▒▓▓▓▓▓▓▓▓▒▓▓▓▓▓██▒▒▓▓▓▓▓▓▓▓▓▓▒▓▓▓▓▓▓▓▓▓▓▓▓▓▓▒▒▓▓▓▓▓███▓▒▓████████████████████████████████████████████████████████████████████▓▓▓▓▓
▓▓▓▓▓▓▓▓▓▓▓▓▓▓▓▓▓▓▓▓▓▓▓▓▓▓▓▓█████████████████████████████████████████▓▓▒▒▒▒░▒▓████▓▒▒▓▓▒▒▒▒▓▓▒▓▓▓▓▓▒▓▓▓▒▓▓▓▒▒▓▓▓▓▓▓▓▓▓▒▒▓▓▓▓▓▓▓▓▓▓▓▓▓▓▒▒▓▓▓▓▓███▓▒▓████████████████████████████████████████████████████████████████████▓▓▓▓▓
▓▓▓▓▓▓▓▓▓▓▓▓▓▓▓▓▓▓▓▓▓▓███████▓▓███████████████████████████████████████▓▒▒▒▒░▒▓████▓▒▒▒▒▒▒▒▒▓▓▒▒▓▓▓▒▒▒▒▓▓▓▒▒▒▒▓▒▓▓▒▒▒▒▒▒▒▓▓▓▓▓▓▓▒▓▓▒▓▓▒▒▒▓▓▓▓▓███▓▒▓████████████████████████████████████████████████████████████████████▓▓▓▓▓
▓▓▓▓▓▓▓▓▓▓▓▓▓▓▓▓▓▓▓▓▓▓▓██▓████████████████████████████████████████████▓▒▒▒▒░▒▓████▒▒▒▒▒▒▒▒▒▓▒▒▒▓▓▓▒▒▒▒▓▓▓▒▒▒▒▓▓▓▓▓▓▒▒▒▒▒▒▓▓▓▓▓▓▒▒▒▒▓▒▒▒▒▓▓▓▓▓███▓▒▓████████████████████████████████████████████████████████████████████▓▓▓▓▓
▓▓▓▓▓▓▓▓▓▓▓▓▓▓▓▓▓▓▓▓▓▓▓███████████████████████████████████████████████▓▒▒▒▒░▒▓████▓▒▒▒▒▒▒▒▒▒▒▒▒▓▒▒▒▒▒▒▒▒▓▒▒▒▒▓▓▒▓▓▓▒▒▒▒▒▒▓▓▓▓▓▒▒▒▒▒▒▒▒▒▒▒▓▓▒▒███▓▒▓████████████████████████████████████████████████████████████████████▓▓▓▓▓
▓▓▓▓▓▓▓▓▓▓▓▓▓▓▓▓▓▓▓▓▓▓▓▓██████████████████████████████████████████████▓▒▒▒▒░▒█████▓▒▒▒▒▒▒▒▒▒▒▒▒▒▒▒▒▒▒▒▒▒▓▒▒▒▒▓▒▒▓▓▓▒▒▒▒▒▒▒▓▓▓▒▒▒▒▒▒▒▒▒▒▒▒▓▓▒▒███▓▒▓████████████████████████████████████████████████████████████████████▓▓▓▓▓
▓▓▓▓▓▓▓▓▓▓▓▓▓▓▓▓▓▓▓▓▓████▓████████████████████████████████████████████▓▒▒▒▒░▒█████▒▒▒▒▒▒▒▒▒▒▒▒▒▒▒▓▒▒▒▒▓▒▓▒▒▒▒▒▒▒▓▓▒▒▒▒▒▒▒▒▒▒▒▒▒▒▒▒▒▒▒▒▒▒▒▒▓▒▒███▓▒▓████████████████████████████████████████████████████████████████████▓▓▓▓▓
▓▓▓▓▓▓▓▓▓▓▓▓▓▓▓▓▓▓▓▓▓█▓████▓██████████████████████████████████████████▓▒▒▒▒░▒▓████▒▒▒▒▒▒▒▒▒▒▒▒▒▒▒▒▒▒▒▒▒▒▓▒▒▒▒▒▒▒▒▒▒▒▒▒▒▒▒▒▒▒▒▒▒▒▒▒▒▒▒▒▒▒▒▒▒▒▒███▓▒▓████████████████████████████████████████████████████████████████████▓▓▓▓▓
▓▓▓▓▓▓▓▓▓▓▓▓▓▓▓▓▓▓▓███████████████████████████████████████████████████▓▒▒▒▒░▒▓████▒▒▒▒▒▒▒▒▒▒▒▒▒▒▒▒▒▒▒▒▒▒▒▒▒▒▒▒▒▒▒▒▒▒▒▒▒▒▒▒▒▒▒▒▒▒▒▒▒▒▒▒▒▒▒▒▒▒▒███▓▒▓████████████████████████████████████████████████████████████████████▓▓▓▓▓
▓▓▓▓▓▓▓▓▓▓▓▓▓▓▓▓▓▓████████████████████████████████████████████████████▓▒▒▒▒░▒█████▒▒▒▒▒▒▒▒▒▒▒▒▒▒▒▒▒▒▒▒▒▒▒▒▒▒▒▒▒▒▒▒▒▒▒▒▒▒▒▒▒▒▒▒▒▒▒▒▒▒▒▒▒▒▒▒▒▒▒███▓▒▓███████████████████████████████████████████████████████████████████▓▓▓▓▓▓
▓▓▓▓▓▓▓▓▓▓▓▓▓▓▓▓██████████████████████████████████████████████████████▓▒▒▒▒░▒█████▒▒▒▒▒▒▒▒▒▒▒▒▒▒▒▒▒▒▒▒▒▒▒▒▒▒▒▒▒▒▒▒▒▒▒▒▒▒▒▒▒▒▒▒▒▒▒▒▒▒▒▒▒▒▒▒▒▒▒███▓▒▓██████████████████████████████████████████████████████████████████▓▓▓▓▓▓▓
▓▓▓▓▓▓▓▓▓▓▓▓▓██▓██████████████████████████████████████████████████████▓▒▒▒▒░▒█████▓▒▒▒▒▒▒▒▒▒▒▒▒▒▒▒▒▒▒▒▒▒▒▒▒▒▒▒▒▒▒▒▒▒▒▒▒▒▒▓▓▒▓▓▒▒▒▒▒▒▒▒▒▒▒▒▒▒▒███▓▒▓██████████████████████████████████████████████████████████████████▓█▓▓▓▓▓
█▓▓█▓▓▓▓▓▓▓▓▓▓▓███████████████████████████████████████████████████████▓▒▒▒▒░▒███████████████████████████████████████████████████████████████████▓▒▓████████████████████████████████████████████████████████████████████▓▓▓▓▓
██▓███▓▓▓▓▓▓██████████████████████████████████████████████████████████▓▒▒▒▒░▒████████████████████████████████████████████████████████████████████▒▓███████████████████████████████████████████████████████████████████▓▓▓▓▓▓
███▓███▓▓▓▓▓▓█████████████████████████████████████████████████████████▓▓▒▒▒░▒███████████████████████████████████████████████████████████████████▓▒▓███████████████████████████████████████████████████████████████████▓▓▓▓▓▓
███▓██████████████████████████████████████████████████████████████████▓▓▒▒▒░▒███████████████████████████████████████████████████████████████████▓▒▓████████████████████████████████████████████████████████████████████▓▓▓▓▓
██████████████████████████████████████████████████████████████████████▓▓▒▒▒░▒███████████████████████████████████████████████████████████████████▓▒▓██████████████████████████████████████████████████████████████████▓▓▓▓▓▓▓
██████████████████████████████████████████████████████████████████████▓▓▒▒▒▒▒▓██████████████████████████████████████████████████████████████████▓▒▓███████████████████████████████████████████████████████████████████▓▓▓▓▓▓
██████▓██████████████████████████████████████████████████████████▓▓▓███▓▒▒▒▒▒▒▒▒▒▒▒▒▒▒▒▒▒▒▒▒▒▒▒▒▒▒▒▒▒▒▒▒▒▒▒▒▒▒▒▒▒▒▒▒▒▒▒▒▒▒▒▒▓▓▒▓▓▓▓▓▓▓▓▓▓▓▓▓▓▓▓▓▓██████████████████████████████████████████████████████████████████████▓▓▓▓▓
█████████████████████████████████████████████████████████████████▒▒▓▓███▓▓▓▓▓▓▓███████████████████████████████████████████████████████████████████████████████████████████████████████████████████████████████████████▓▓▓▓▓▓
███████▓▓▓███████████████████████████████████████████████████████▓▒▓▓▓████████████████████████████████████████████████████████████████████████████████████████████████████████████████████████████████████████████████▓▓▓▓▓▓
████████▓▓▓███████████████████████████████████████████████████████████████████████████████████████████████████████████████████████████████████████████████████████████████████████████████████████████████████████████▓▓▓▓▓▓
███████▓█▓▓▓██████████████████████████████████████████████████████████████████████████████████████████████████████████████████████████████████████████████████████████████████████████████████████████████████████████▓▓▓▓▓▓
█████▓▓▓▓▓▓▓▓██████████████▓▓▓▓▓▓▓▓▓▓▓▓▓▓▓▓▓▓▓▓▓▓████████████████████████▓▓▓▓▓▓██████████████████████████████████████████████████████████████████████████████████████▓████████████████████████████████████████████████▓▓▓▓▓▓
███▓▓▓▓▓▓▓▓▓▓▓███████████▓▓▓▓▒▒▒▓▓▒▒▒▓▓▓▓▓▓▓▓▓▓█████████████████████████▓▒▒▒▒▒▓▓▓███████████████████████████████████████████████████████████████████████████████████▓▓▓▓▓█████████████████████████████████████████████▓▓▓▓▓▓
▓▓▓▓▓▓▓▓▓▓▓▓▓▓▓▓▓▓▓▓▓▓▓▓▓▓▒▒▒▒▒▒▒▒▒▒▒▒▒▒▒▒▒▒▒▓▓█████████████████████████▒▒▒░▒▒▓████████████████████████████████████████████████████████████████████████████████████▓▒▒▒▒▓██████▓▓▒▒▒▓▓██████▓█████████████████████████▓▓▓▓▓▓
▓▓▓▓▓▓▓▓▓▓▓▓▓▓▓▓▓▓▓▓▓▒▒▒▒▒▒▒▒▒▒▒░░░░░░░░▒▒▒▒▒▒▓█████████████████████████▒▒▒░░▒▒██████████████████████████████████████████████████████████████████████████████▓▓▓▒▒▒▒▒▒▒▒▓████▓▒▒▒▒▒▒▒▒▒▒▓███▓█████████████████████████▓▓▓▓▓▓
▓▓▓▓▓▓▓▓▓▓▓▓▓▓▒▒▒▒▒▒▒░░░░▒▒▒▒▒▒░░░░░░░░░░░▒▓▒▒▓█████████████████████████▓▒░░░▒▒▓█████████████████████████████████████████████████████████████████████████▓▓▒▒▒▒▒▒▒▒▒░░▒▒▓███▓▒▒▒▒▒▒▒▒▒▒▒▒▓██▓████████████████████████▓▓▓▓▓▓▓
▓▓▓▓▓▓▒▒▒▒▒▒▒▒▒▒▒▒░░░░░░░▒▒▒▒▒░░░░░░▒▒░░░░▒▒▒▒▓███████████████████▓██████▒▒░░▒▒▓████████████████████████████████████████████████████████████████████▓▓▓▒▒▒▒▒▒▒▒▒▒▒▒░░░░▒▓██▓▒▒▒▒▒░▒▓▒▒▒▒▒▓██▓█████████████████████████▓▓▓▓▓▓
▓▒▒▒▒▒▒▒▒▒▒▒▒▒▒▒▒░░░░░░░░▒▒▒▒▒▒░░░░░░░░░░░▒▒▒▒▓███████████████████▓██████▓▒▒▓███████████████████████████████████████████████████████████████████▓▓▓▓▒▒▒▒▒▒▒▒▒▒▒▒▒▒░░░░░░▓███▒▓▒▓▓░░▒▒▒▒▒▒▓██▓█████████████████████████▓▓▓▓▓▓
▒▒▒▒▒▒▒▒▒▒▒▒▒░░░░░░░░░░░░▒▒▓▒▒▒▒▒░░░░░░░░▒▒▓▓▓▓███████████████████▓██████████████████████████████████████████████████████████████████████████▓▓▓▓▒▒▒▒▒▒▒▒▒▒▒▒▒▒░▒░░░░░░░▓███▓▓█▓▓▓▓▒▒▒▒▒▓███▓████████████████████████▓▓▓▓▓▓▓
▒▒▒▒▒▒▒▒▒▒▒▒░░▒░░░░░░░░░░▒▒▒▒▒▒▒▒░░░░░░░▒▒▒▓▒▒▓███████████████████▓████████████████████████████████████████████████████████████████████▓▓▓▓▓▓▓▒▒▒▒▒▒▒▒▒▒▒▒▒▒▒▒░░░░░░░░░░▓████▓▓▓▓▒▒▒▒▒▒▓████▓███████████████████████▓▓▓▓▓▓▓▓
▒▒▒▒▒▒▒▒▒▒▒▒▒░░░░░░░░░░░░▒▓▓▒▒▒▒▒▒▒▒▒▒▒▒▓▓▒▓▒▒▓█████████████████████████████████████████████████████████████████████████████████████▓▓▓▓▓▓▓▓▒▒▒▒▒▒▒▒▒▒▒▒▒▒▒▒▒▒░▒░░░░░░░░▓████▓▓▓▓▓▓▓▓▓██████▓█████████████████████████▓▓▓▓▓▓
▒▒▒▒▒▒▒▒▒░░░░░░░░░░░░░░░░▒▓▓▒▒▒▒▒▒▒▒▒▒▒▒▒▓▒▓▓▓▓████████████████████████████████████████▓▒▒▒▓██████████████████████████████████████▓▓▓▓▓▓▓▓▓▒▒▒▒▒▒▒▒▒▒▒▒▒▒▒▒▒░░░░░░░░░░░░▓████▓▓▒▒▒▒▒▒▓▓▓████▓█████████████████████████▓▓▓▓▓▓
▒▒▒▒▒▒▒▒▒▒▒▒░░░░░░░░░░░░░▒▓▓▒▒░░░░░░░░░░░▒▒▓▓▓▓█████████████████████████████████████▓▓█▓▒▒▒▒▒▒▒▓▓▓████▓█▓▓▓▓▓▓▓▓▓▓▓▓▓▓▓▓▓▓▓▓▓▓▓▓▓▓▓▓▓▓▓▓▒▒▒▒▒▒▒▒▒▒▒▒▒▒▒▒▒▒▒░░░░░░░░░░░░░▒▓▓▓▒▒▒▒▒▒░░▒▒▒▒▒▓██▓█████████████████████████▓▓▓▓▓▓
▒▒▒▒▒▒▒▒▒▒░░░░░░░░░░░░░░░▒▒▒░░░░░░░░░░░░░░░▒▒▓▓███████████████████████████████████████▓▒▒░░░▒▒▓▓▓▒▒▒▓▓▓▓██▓▓▓▓▓▓▓▓▓▓▓▓▓▓▓▓▓▓▓▓▓▓▓▓▓▓▓▓▓▓▓▓▒▒▒▒▒▒▒▒▒▒▒▒▒▒▒░░░░░░░░░░░░░░░▒█▓▒▒▒▒▒░░░░░░░░▒▒▒▓▓█████████████████████████▓▓▓▓▓▓
▒▒▒▒▒▒▒░░░░░░░░░░░░░░░░░░▒▒▒░░░░░░░░░░░░░░░░▒▒▓██████████████████▓███████████████████▓▓▒░░░░░░▒▒▓█▓▒▒▒░▒▒▒▒▒▒▒▒▓▓▒▒▓▓▓▒▒▒▒▒▒▒▒▒▒▒▓▓▓▓▓▓▓▓▓▒▒▒▒▒▒▒▒▒▒▒▒▒▒░░░░░░░░░░░░░░░░▒▓▒▒▒▒▒▒▒░░░░░░░░░▒▒▓▓███████████████████████▓▓▓▓▓▓▓
▒▒▒▒▒▒▒░░░░░░░░░░░░░░░░░░▒▒░░▒▒▒▒▒░░░░░░░░░░░▒▓███████████████████▓████████████▓▓▒▒▒▒▒▒▒░░░▒▒▒▒▒▒▒▒▒░░░░░░░░░▒▒▒▒▒▒▒▒▒▒▒▒▒▒▒▒▒▓▒▓▓▒▒▒▒▒▒▒▒▒▒▒▒▒▒▒▒▒▒▒▒▒░░░░░░░░░░░░░░░░░▒░▒▒▒▓▓▓▒░▒▓▒░░░░░▒▒▒█████████████████████████▓▓▓▓▓▓
▒▒▒▒░▒▒▒░░▒░░░░░░░░░░░░░░▒▒░░▒▒▓▓▓░░▒▒░░░░░░░▒▓██▓▓▓▓█████████████▓█████████▓▓▓▓▒▒▒▒▒▓▓▒▒▒▒▒▒▒▒▒▒▒▒▒░░░░░░▒▒▒▒▒▒▒▓▒▒▓▓▒▓████▓▓▒▒▒▒▒▒▒▒▒▒▒▒▒▒▒▒▒▒▒▒▒▒▒▒░░░░░░░░░░░░░░░░░░▒░▒▒▓██▓▒░▒▒▒░░░░░▒▒▒████████████████████████▓▓▓▓▓▓▓
▒▒▒░▒░░░░▒░░░░░░░░░░░░░░░▒▒░░▒▒▓▓▓▒▒░░░░░░░░░▒▓▓▓▓▓▓▓████████████▓▓████▓▓▓▓▓▓▓▒▒▒▒▒▒▒▒▒▒▒▒▒▒▒▒▒▒▒▒▒▒▒▒▒▒▒░▒░▒▒▒▒▒▒▒▒▒▒▒▒▒▒▓▒▒▒▒▒▒▒▒▒▒▒▒▒▒▒▒▒▒▒▒▒▒░▒▒▒▒▒▒▒▒▒▒▒▒▒░░░░░░░░░▒▒▒▒▓████▓▒▒▒▒░░░░▒▒▒████████████████████████▓▓▓▓▓▓▓
▒▒▒░░▒░░░░░░░░░░░░░░░░░░░▒▒▒░▒▒▒▒▒▒▒░░░░░░░░▒▒▓▓▓▓▓▓▓▓████████▓▓▓▓▓▓▓▓▓▓▓▓▓▓▒▒▒▒▒▒▒▒▒▒▒▒▒▒▒▒▒▒▒▒▒▒▒▒▒▒▒▒▒▒▒▒▒▒▒▒▒▒▒▒▒▒▒▒▒▒▒▒▒▒▒▒▓▓▓▓▓▓▓▓▓▓▓▒▒▒░░░░▒▒▒▒▒▒▒▒▒▒▒▒▒▒░░░░░░░░▓▓▒▒▒▓████▓▒▒▒▒▒▒▒▒▒▓████████████████████████▓▓▓▓▓▓▓
▒▒░░░░▒░░░░░░░░░░░░░░░░░░▒▒▒▒░░░▒▒▒▒░░░░░░░▒▒▒▒▓▓▓▒▓▓▓████▓█▓▓▓▓▒▒▒▒▒▒▒▒▒▒▒▒▒▒▓▓▓▓▓▓▓▓▓▓▓▒▒▒▒▒▒▒▒▒▒▒▒▒▒▒▒▒▒▒▒▒▒▒▒▒▒▒▒▒▒▒▒▒▒▒▒▒▒▓▓▓▓▓▓▓▓▓▓▓▓▓▒░░░░▒▒▒▓▓▓▓▓▒▒▒▒▒▒░░░░░░░░░▓█▓▒▒▒▒▓▓▓▓▒▒▒▒▒▒▒▒█▓████████████████████████▓▓▓▓▓▓▓
▒▒▒░░░▒░▒▒░░░░░░░░░░░░░░░▒▒▒▒▒▒░░░░░░░░░░▒▒▒▓▒▒▓▒▒▒▒▒▓██▓▓▓▓▓▓▒▒▒░░▒▒░░░▒▒▒▒▒▒▓▓▓▓▓▓▓▓▓▒▒▒░▒▒▒░░░░░░░░░▒░░░▒█▒░░░░▒▒░▒▒▒▒░░░░▒▒▒▓▓▓▓▓▓▓▓▓▓▓▓▒░░░▒▒▒▓█████████▓▒▒▒░░░░░░░▓█▓█▓▒▒▒▒▒▒▒▒▒▒▒▒▓██▓████████████████████████▓▓▓▓▓▓▓
▒▒▒▒░░░░░░░░░░░░░░░░░░░░░▒▒▒▒▒▒▒▒▒▒▒▒▒▒▒▒▒▒▒▓▒▒▒▒▒▒▒▒▓▓▓▓▓▒▒▒▒▒▒▒░░░░░░░▒▒▒▒▒▒▒▓▓▓▓▓▓▓▒▒▒▒▒▒▒▒▒▒▒▒▒▒▒▒▒▒▒░░▒▒▒▒▒▒▒▒▒▒▒▒▒▒▒▒░▒▒▒▓▓▓▓▓▓▓▓▓▓▓▓▓▒▒▒▒░░▒▒▓██████▓▓▓▒░░░░░░░░░▓█▓███▓▓▓▒▒▒▒▓▓▓████▓▓███████████████████████▓▓▓▓▓▓▓
▒▒▒░░▒░▒░░▒░░░░░░░░░░░░░░▒▒▒▒▒▒▒▒▒▒▒▒▒▒▒▒▒▒▒▒▒▒▒▒▓▓▓▒▒▒▒▒▒▒▒▒▒▒▒▒▒▒▒▒░░▒▒▒▒▒▒▒▒▓▓▒▒▒▒▒▒▒▒▒▒▓▓▓▓▓▓▓▓▓▓▒▒▒▒▒▓▓▓▓▓▓▓▓▓▓▓▓▓▓▓▒▒▒▓▓▓▓▓▓▓▓▓▓▓▓▓▓▓▓▓▓▓▓▒▒▒▓▓▓▓▓▓▓▓▓▓▒▒▒▒▒▒░░░░░▒█▓████▓▓▓██▓█▓▓▓███▓▓██████████████████████▓▓▓▓▓▓▓▓
▒▒▒▒▒▒░░░░░░░░░░░░░░░░▒▒▒▒▒▒▒▒▒▒▒▒▒▒▒▒▒▒▒▒▒▒▒▒▓▓▓▓▓▓▓▓▓▓▓▒▒▒▒▒▒▒▒▒▒▒▒▒▒▒▒▒▒▒▒▒▒▒░░░░░░░░░░░░░░░░░░░░░░░░░░░░░░░░░░░░░░░░░░░░░░░░░░░░▒▓▓▓▓▓▓▓▓▓▓▓█▓▓██████████████████████████████████████████████████████████████████▓▓▓▓▓▓▓
▒▒▒▒░░▒░▒░░░░░░░░░░░▒▒▒▒▒▒▓▓▒▒▒▒▒▒▒▒▒▒▒▒▒▒▒▒▓▓▓▓▓▓▓▓▓▓▓▓▓▓▓▓▓▓▓▓▓▓▓▓▓▓▓▓▓▓▓▓▓▒▒▒▒▒▒▒▒▒▒▒▒▒▒▒▒▒▒▒▒▒▒▒▒▒▒▒▒▒▒▒▒▒▒▒▒▒▒▒▒▒▒▒▒▒▒▒▒▒▒▓▓▒▒▓▓▓▓▓▓▓▓█████████████████████████████████████████████████████████████████████████▓▓▓▓▓▓▓▓
▒▒▒▒▒░░░░░░░░░░░░░▒▒▒▒▒▒▓▓▒▓▓▒▓▓▒▒▒▒▒▒▒▒▒▓▓▓▓▓▓▓▓▓▓▓▓▓▓▓▓▓▓▓▓▓▓▓▓▓▓▓▓▓▓▓▓▓▓▓▓▓▓▓▓▓▓▓▓▓▓▓▓▓▓▓▓▓▓▓▓▓▓▓▓▓▓▓▓▓▓▓▓▓▓▓▓▓▓▓▓▓▓▓▓▓▓▓▓▓▓▓▓▓▓▓▓▓█████████████████████████████████████████████████████████████████████████████▓▓▓▓▓▓▓▓▓
▒▒░▒▒░░▒░░░░░░░░░▒▒▒▒▒▒▒▒▒▒▒▒▒▒▒▒▒▒▒▒▒▒▒▒▒▒▒▒▒▒▒▒▒▒▒▒▒▒▒▒▒▒▒▒▒▒▒▒▒▒▒▒▒▒▒▒▒▒▒▒▒▒▒▒▒▒▒▒▒▒▒▒▒▒▒▒▒▒▒▒▒▒▒▒▒▒▒▒▒▒▒▒▒▒▒▒▒▒▒▒▒▒▒▒▒▒▒▒▒▒▒▒▒▒▒▒▒▒▒▒▒▒▒▒▒▒▒▒▒▒▒▓▓▒▒▒▒▓▓▓▓▓▓▓▓▓▓▓▓▓▓▓▓▓▓▓▓▓▓▓▓▓▓▓▓▓▓▓▓▓▓▓▓▓▓▓▓▓▓▓▓▓▓███████████▓▓▓▓▓▓▓▓▓
▒▒▒▒▒░░░░░░░░░░░░▒▒▒▒▒▒▒▒▒▒▒▒▒▒▒▒▒▒▒▒▒▒▒▒▒▒▒▒▒▒▒▒▒▒▒▒▒▒▒▒▒▒▒▒▒▒▒▒▒▒▒▒▒▒▒▒▒▒▒▒▒▒▒▒▒▒▒▒▓▓▓▓▓▓▓▓▓▓▓▓▓▓▓▓▒▒▒▒▒▓▓▓▓▓▓▓▓▓▓▓▓▓▓▓▓▓▓▓▓▓▓▓▓▓▓▓▓▓▓▓▓▓▓▓▒▒▓▓▓▓▒▒▒▒▒▒▒▒▒▒▒▒▒▒▒▒▒▒▒▒▒▒▒▒▒▒▒▒▒▒▒▒▒▒▒▒▒▒▓▓▓▓▓▓▓▓▓▓▓▓▓▒▒██████████▓▓▓▓▓▓▓▓▓▓
░░░░░░▒░░░░░░░░░░▒▒▒▒▒▒▒▒▒▒▒▒▒▒▒▒▒▒▒▒▒▒▒▒▒▒▒▒▒▒▒▒▒▒▒▒▒▒▒▒▒▒▒▒▒▒▒▒▒▒▒▒▒▒▒▓▒▒▓▒▒▒▓▓▓▓▓▓▓▓▓▓▓▓▓▓▓▓▓▓▓▓▓▓▒▒▒▒▒████▓▓▓▓▓▓▓▓▓▓▓▓▓▓▓▓▓▓▓▓▓▓▓▓▓▓▓▓▓▒▒▒▒▒▓▓▓▓▓▓▓▓▓▓▓▓▓▓▓▓▓▓▓▓▓▓▓▓▓▓▓▓▓▓▓▓▓▓▓▓▓▓▓▓▓▓▓▓▓▓▓▓▓▓▓▓▓▓▒▒██████████▓▓▓▓▓▓▓▓▓▓
░░░░░░░░░░░░░░░░░▒▒▒▒▒▒▒▒▒▒▒▒▒▒▒▒▒▒▒▒▒▒▒▒▒▒▒▒▒▒▒▒▒▒▒▒▒▒▒▒▒▒▒▒▒▒▒▒▒▒▒▒▒▒▒▓▓▓▓▓▓▓▓▓▓▓▓▓▓▓▓▓▓▓▓▓▓▓▓▓▓▓▓▓▒▒▒▒▒▓▓▓▓▓▓▓▓▓▓▓▓▓▓▓▓▓▓▓▓▓▓▓▓▓▓▓▓▓▓▓▓▓▓▒▒▓▓▓▓▓▓▓▓▓▓▓▓▓▓▓▓▓▓▓▓▓▓▓▓▓▓▓▓▓▓▓▓▓▓▓▓▓▓▓▓▓▓▓▓▓▓▓▓▓▓▓▓▓▓▓▓▒▒██████████▓▓▓▓▓▓▓▓▓▓
░░░░░░░░░░░░░░░░░▒▒▒▒▒▒▒▒▒▒▒▒▒▒▒▒▒▒▒▒▒▒▒▒▒▒▒▒▒▒▒▒▒▒▒▒▒▒▒▓▓▒▒▓▓▓▓▓▓▓▓▓▓▓▓▓▓▓▓▓▓▓▓▓▓▓▓▓▓▓▓▓▓▓▓▓▓▓▓▓▓▓▓▓▓▓▓▓▓▓▓▓▓▓▓▓▓▓▓▓▓▓▓▓▓▓▓▓▓▓▓▓▓▓▓▓▓▓▓▓▓▓▓▓▓▓▓▓▓▓▓▓▓▓▓▓▓▓▓▓▓▓▓▓▓▓▓▓▓▓██████████████▓███▓▓▓▓█████████████████████▓▓▓▓▓▓▓▓▓▓
░░░░░░░░░░░░░░░░░░░░▒▒▒▒▒▒▒▒▒░░░░░░░░░▒▒▒▒▒▒▒▒▒▒▒▒▒▒▒▒▒▒▒▒▒▒▒▒▒▒▒▒▒▒▒▒▒▒▒▒▒▒▒▒▒▒▒▒▒▒▒▒▒▒▒▒▒▒▒▒▒▒▒▒▒▒▒▒▒▒▒▒▒▒▒▒▒▒▒▒▒▒▒▒▒▒▒▒▒▒▒▒▒▒▒▒▒▒▒▒▒▒▒▒▒▒▒▒▒▒▒▒▒▒▒▒▒▒▒▒▒▒▒▒▒▒▒▒▒▒▒▒▒▓▓▓▓█████████▓░▒▓██▒▒▒▓████████████████████▓▓▓▓▓▓▓▓▓▓
░░░░░░░░░░░░░░░░░░░░▒░░▒▒░░▒░░░░░░░░░▒▒▒▒▒▒▒▒▒▒▒▒▒▒▒▒▒▒▒▒▒▒▒▒▒▒▒▒▒▒▒▒▒▒▒▒▒▒▒▒▒▒▒▒▒▒▒▒▒▒▒▒▒▒▒▒▒▒▒▒▒▒▒▒▒▒▒▒▒▒▒▒▒▒▒▒▒▒▒▒▒▒▒▒▒▒▒▒▒▒▒▒▒▒▒▒▒▒▒▒▒▒▒▒▒▒▒▒▒▒▒▒▒▒▒▒▒▒▒▒▒▒▒▒▒▒▒▒▓▓▓▓▓███████████▒▒███▒▒▒▓████████████████████▓▓▓▓▓▓▓▓▓▓
░░░░░░░░░░░░░░░▒▒░░░░▒░░▒▒▒▒░░░▒▒░░░░▒▒▒▒▒▒▒▒▒▒▒▒▒▒▒▒▒▒▒▒▒▒▒▒▒▒▒▒▒▒▒▒▒▒▒▒▒▒▒▒▒▒▒▒▒▒▒▒▒▒▒▒▒▒▒▒▒▒▒▒▒▒▒▒▒▒▒▒▒▒▒▒▒▒▒▒▒▒▒▒▒▒▒▒▒▒▒▒▒▒▒▒▒▒▒▒▒▒▒▒▒▒▒▒▒▒▒▒▒▒▒▒▒▒▒▒▒▒▒▒▒▒▒▒▒▒▒▓▓▓▓█████████████▒▒███▓▒▓█████████████████████▓▓▓▓▓▓▓▓▓▓
░░░░░░░░░░░░░░░░░▒▒░░░▒▒▒▒▒▒░░░▒▒░░░▒▒▒▒▒▒▒▒▒▒▒▒▒▒▒▒▒▒▒▒▒▒▒▒▒▒▒▒▒▒▒▒▒▒▒▒▒▒▒▒▒▒▒▒▒▒▒▒▒▒▒▒▒▒▒▒▒▒▒▒▒▒▒▒▒▒▒▒▒▒▒▒▒▒▒▒▒▒▒▒▒▒▒▒▒▒▒▒▒▒▒▒▒▒▒▒▒▒▒▒▒▒▒▒▒▒▒▒▒▒▒▒▒▒▒▒▒▒▒▒▒▒▒▓▓▓▓▓▓▓▓▓█████████████▒▒███▓▒▓████████████████████▓▓▓▓▓▓▓▓▓▓▓
░░░░░░░░░░░░░░░░▒▒▒▒▒░░░▒▒▒▒░░░▒▒░░░▒▒▒▒▒▒▒▒▒▒▒▒▒▒▒▒▒▒▒▒▒▒▒▒▒▒▒▒▒▒▒▒▒▒▒▒▒▒▒▒▒▒▒▒▒▒▒▒▒▒▒▒▒▒▒▒▒▒▒▒▒▒▒▒▒▒▒▒▒▒▒▒▒▒▒▒▒▒▒▒▒▒▒▒▒▒▒▒▒▒▒▒▒▒▒▒▒▒▒▒▒▒▒▒▒▒▒▒▒▒▒▒▒▒▒▒▒▒▒▒▓▓▓▓▓▓▓▓▓▓▓▓█████████████▒▒███▓▒▓████████████████████▓▓▓▓▓▓▓▓▓▓▓