░░░░░░░░░░░░░░▒▒▓▓▓▓▒░ ░▒▓██████████████████████████████████████████████████████████████████████     ░░░▓███████████████████████████████████████████████████████████████████████████▓▒░░░▒▒░░▓██████████████████████████████
░░░░░░░░░░░░░░▒▒▓▓▓▓▒░░░▒▓██████████████████████████████████████████████████████████████████████     ░░░▓███████████████████████████████████████████████████████████████████████████▓▒░░░▒▒░▒▓██████████████████████████████
░░░░░░░░░░░░░░▒▒▓▓▓▓▒░░░▒▓██████████████████████████████████████████████████████████████████████     ░░▒▓███████████████████████████████████████████████████████████████████████████▓░░░░▒▒░▒███████████████████████████████
░░░░░░░░░░░░░░▒▒▒▓▓▓▒░░░░▓██████████████████████████████████████████████████████████████████████     ░░░▓███████████████████████████████████████████████████████████████████████████▓░░░░▒░░▒███████████████████████████████
░░░░░░░░░░░░░░▒▒▒▓▓▓▓▒░ ░▓██████████████████████████████████████████████████████████████████████     ░░░▒▓██████████████████████████████████████████████████████████████████████████▒░░░▒▒░░▒███████████████████████████████
░░░░░░░░░░░░░░░▒▒▓▓▓▓▒░░░▓██████████████████████████████████████████████████████████████████████░     ░░▒███████████████████████████████████████████████████████████████████████████▒░░░▒▒░░▒███████████████████████████████
░░░░░░░░░░░░░░▒▒▒▓▓█▓▒░ ░▓██████████████████████████████████████████████████████████████████████░     ░░▒████████████████████████████████████▓▓████████████████████████████████████▓▒░░░▒▒░░▒███████████████████████████████
░░░░░░░░░░░░░░░▒▒▓▓▓▓▒░░░▒██████████████████████████████████████████████████████████████████████░     ░░▒▓████████████████████████▓▓▓▓▓▒▒▓▓▓▓▓▓▓▓▓▓████████████████████████████████▓▒░░░▒▒░░▓███████████████████████████████
░░░░░░░░░░░░░░░▒▒▓▓▓▓▒░ ░▒██████████████████████████████████████████████████████████████████████▒     ░░▒▓███████████████▓▓▓▓▓▓▒▓▓▓▓▓▓▓▓▓▓▓▓▓▓▓▓▓▓▓▓▓██████████████████████████████▓▒░░░▒▒░░▓███████████████████████████████
░░░▒░░░░░░░░░░░▒▒▓▓▓▓▒░░░▒██████████████████████████████████████████████████████████████████████▒     ░░░ ░▓███▓▓▒▒▒▒▒▓▓▓▓▓▓▓▓▓▓▓▓▓▓▓▓▓▓▓▓▓▓▓▓▓▓▒▒▒▓▓▓█████████████████████████████▓▒░░░▒▒░░▓███████████████████████████████
░░░▒▒░░░░░░░░░░▒▒▓▓▓▓▒░░░▒███████████████████████████████████████████████████████████████████████▓    ░░░  ░▒▓▓▓▓▓▓▓▓▓▓▓▓▓▓▓▓▓▓▓▓▒▒▒▒▒▒▒▒▒▓▓▒▒▓▒▒▒▒▓▓▓▓████████████████████████████▓▒░░░▒▒░▒▓███████████████████████████████
░░▒▒▒░░░░░░░░░▒▒▒▓▓▓▓▓░░░▒▓███████████████████████████████████████████████████████████████▓▓▓▓▓▓▓▓     ░░  ░▓▓▓▓▓▓▓▓▓▓▓▓▓▓▓▓▓▓▓▓▓▓▒▒▓▒▒▓▓▒▒▒▒▒▓▒▒▒▒▓▓▓▓▓███████████████████████████▓▒░░░▒▒░▒▓███████████████████████████████
░░░▒▒░░░░░░░░▒░▒▒▓▓█▓▓░░░▒██████████████████████████████████████████████████████▓▓▓▓▓▓▓▓█▓▓▓▓█▓▓▓▓     ░░  ░▓▓██▓▓▓▓▓▓▓▓▓▓▓▓▓▒▒▓▓▓▓▒▒▒▒▒▒▒▒▓▒▒▒▒▒▓▒▒▓█▓▓▓██████████████████████████▓▒░░░▒▒░▒████████████████████████████████
░░░▒▒░░░░░░░▒░░▒▒▓▓██▓▒░░▒▓██████████████████████████████████████████████▓█▓▓▓▓▓▓▓▓▓▓▓▓██▓▓▓▓█▓█▓▓    ░░░  ░▓██▓▓▓▓▓▓▓▓▓▓▓▓▓▓▓▓▓▓▓▒▓▓▓▓▓▓▓▒▒▓▓▓▓▒▓▒▒▒▒▓▓▓██████████████████████████▓▒░░▒▒▒░▒████████████████████████████████
░░▒▒▒▒░░░░░░▒▒░▒▒▓▓██▓▒░░▒▓███████████████████████████████████████▓▓▓▓▓▓▓▓▓▓▓▓▓▓▓▓▓▓▓▓▓█▓▓███▓▓▓▓▒     ░░  ░▓▓▓▓▓▓▓▓▓▓▓▓▓▓▓▓▓▓▓▓▒▓▓▓▓▓▓▓▒▒▒▒▓▓▓▒▒▒▒░░▒▓▓▓██████████████████████████▓▒░░▒▒▒░▒████████████████████████████████
░░░▒▒▒░░░░░░░▒░▒▒▓▓██▓▒░░▒▓██████████████████████████████▓▓▓▓▓▓▓▓▓▓▓▓▓▓▓▓▓▓▓▓▓▓▓▓▓▓▓█▓█▓▓▓██▓▓▓▓▓▒     ░░  ░▒▓▓▓▓▓▓▓▓▓▓▓▒▒▒▒▒▒▒▒▓▓▓▓▓▓▓▓▒▒▓▓▓▓▓██▒▓▒░▒▓▓▓██████████████████████████▓░░░▒▒░░▒████████████████████████████████
░░░▒▒▒░░░░░░▒▒▒▒▒▒▓██▓▒░░░▓████████████████████████████▓▓▓▓▓▓▓▓▓▓▓▓▓▓▓▓▓▓▓▓▓▓▓▓▓▓▓▓▓▓▓▓▓▓▓▓▓▓▓▓▓▓▒     ░░  ░▒▒▓▓▒▒▒▒▒▓▓▓▓████░░▒▓▓▓▓▓▓▓▓▒▒▒▓▓▓▒█▓▒▓▓▒▒▓▓▓██████████████████████████▒░░░▒▒░░▓█████████████████████████▓▓▓▓▓▒▒
░░░▒▒▒░ ░░░░░▒▒▒▒▓▓██▓▒░░░▓██████████████████████████▒▒▒▓▓▓▓▓▓▓▓▓▓▓▓▓▓▓▓▓▓▓▓▓▓▓▓▓▓▓█▓█▓▓▓▓▓▓▓▓▓▓▓▒         ░▒▒▒▒▒░ ░▒▒▓▓█████▒░▒▒▓▓▓▓▓▓▓▒▓▓▓▓▓▒▓███▓▒▒▓▓▓██████████████████████████▒░░░▒▒░░▓███████████████████▓▓▓▓▒▒▒▒▒▒▒▒▒
░░░▒▒▒░░░░░░▒▒▒▒▒▒▓▓█▓▒░░░▓████████████████████████▒░░▒▓▓▓▓▓▓▓▓▓▓▓▓▓▓▓▓▓▓▓▓▓▓▓▓▓▓▓████▓█▓▓▓▓▓▓▓▓▓▒  ░░▒▒▒░ ░▒▒▒▒▒░░░ ░░░▒▒▓▓████▓▓▓▓▓▓▓▒▒▒▒▓▓▓▓████▓▒▓▓▓███████████████████████████▒░░░▒▒░░▓████████████▓▓▓▓▒▒▒▒▒▒▒▒▒▒▒▒▒▓▓▓
░░░▒▒▒▒░░░░░░▒▒▒▒▒▓▓██▒░░░▓███████████████████████▒░░▒▓▓▓▓▓▓▓▓▓▓▓▓▓▓▓▓▓▓▓▓▓▓▓▓▓▓▓▓▓▓▓▓▓▒▒▓▒░▒█████████████▒░▒▓████████████▓▒░░░▒████▓▓▓▒▒▒▓▓▓▓▓▒▒▒▒▓▓▒▓████████████████████████████▒░░░▒░░░▓█████▓▓▓▓▓▒▒▒▒▒▒▒▒▒▒▓▓▓▓▓▓▓▓▓▓▓▓
░░░▒▒▒▒░░░░░░▒▒▒▒▒▓▓██▒░░░▒██████████████████████▒░░▒▓▓▓▓▓▓▓▓▓▓▓▓▓▓▓▓▓▓▓▓▓▓▓▓▓▓▓▒▒▓███████████████████▓▓▓▒▓███████████████████▒ ░░▓███▓▒▒▒▓▒▒▒▒▒▒▒▓█▓▓▓████████████████████████████▒░░░▒░░▒▒▓▓▒▒▒▒▒▒▒▒▓▓▓▓▓▓▓▓▓▓▓▓██████████
░░░▒▒▒▒░░░░░░▒▒▒▒▒▓▓██▓░░░▒█████████████████████▓ ░░▓▓▓▓▓▓▓▓▓▓▓▓▓▓▓▓▓▓▓▓▓▓▓▓▓▓▓░░▒▓▓▓▓██████████▓██▓▓▓▓▓▓██████▓▓█▓▓▓▓▓▒▒▓██████░▒░████▓▓▒▒▓▒▒▒▒▒▓▓▓███████████████████████████████▒░░░▒▒▒▒▒▒▒▓▓▓▓▓▓▓▓▓█████████████████████
░░░▒▒▒▒░░░░░░▒▒▒▒▒▓▓██▓░░░▒████████████████████▓░ ░░▓▓▓▓▓▓▓▓▓▓▓▓▓▓▓▓▓▓▓▓▓▓▓▓▓▓▒       ▒▓█████▓▓▒▓▓▒▒▒▓▓▓▓█████▓▒▓███▓▓▓▓▒▒▒▒░░▒▒ ░█████▓▓▓▒▒▒▒▓▓▓▓▓▒▓██████████████████████████████▒▒▒▒▒▓▓▓▓▓▓▓▓████████████████████████████
░░░░▒▒▒░░░░░░▒▒▒▒▒▓▓██▓▒░░▒████████████████████▒  ░▒▓▓▓▓▓▓▓▓▓▓▓▓▓▓▓▓▓▓▓▓▓▓▓▓▓▒░        ▒▓█████▓▓▒▒▒▒▓▓▒▓██▓▓▓▓▒▒░░     ░▒▒░▒▒▒▒▓███████▓▒▒▒▓▓▓▓▓▓▓▓████████████████████████████████▓▓▓▓▓▓▓▓█████████████████████████████████
░░░░▒▒▒░░░░▒▒░▒▒▒▒▓▓██▓▒░░▒▓██████████████████▓░ ░░▓▓▓▓▓▓▓▓▓▓▓▒▒▓▓▓▓▓▓▓▓▓▓▓▓▒░           ░▒▓▓█████▓██▓▓▓███▓▒░░░░░   ░▒▒▒▓▓████████████▓▓▓▓▓▓▓▓▓▓▓██████████████████████████████████████████████████████████████████████████
░░░░▒▒▒░░░░▒▒░▒▒▒▒▒▓▓█▓▒░░▒▓██████████████████▒  ░▒▓▓▓▓▓▒▓▒░▒▓▒▒▒▓▓▓▓▓▓▓▓▓▒░░               ░░░▒▒▒▓▓▓▓█████████████▒▒▒▒▒▒████████▓▓████▓▓▓▓▓▓▓▓▓████████████████████████████████████████████████████████████████████████████
░░░░░▒▒▒░░░▒▒▒▒▒▒▒▓▓▓█▓▒░░▒▓██████████████████▒░ ░▒▓▓▓▓▓▓██▓▓█▒▒▓▓▓▓▓▓▓▓▒▒░░░               ░░░░░░ ░░░ ░░░░░▒▒▒▒▒▒█▓▒▒▒░ ▓▓▓▓▒▒▒▒▒▒▒████▓▒▒▓▓▓██████████████████████████████████████████████████████████████████████████████
░░░░░▒▒▒░░░▒▒░▒▒▒▒▓▓▓█▓▒░░▒▓█████████████████▓▒░  ▒▓▓▓▓▒▒█████▓▓▓▓▓▓▓▓▓▒▒░░░░░ ░            ░░░░░░             ░░░▒▓▓▒▓░ ▒▓▓▒▒▒▒▒▓████▓█▒▒▓▓████████████████████████████████████████████████████████████████████████████████
░░░░░▒▒▒░░░▒▒▒░▒▒▒▓▓██▓▒░░░▓█████████████████▓▒░  ▒▓▓▓▓▓▓▓▒███▓▓▓▓▓▓▓▒▒░░░░░░░░░       ░░░░░░░░░░░             ░░░▒▒▒▒▒░ ▒▓▓▓▓▓██▒█▒▓█▓█▓███████████████████████████████████████████████████████████████████████████████████
░░░░░░▒▒░░░░▒░▒▒▒▒▒▓██▓▒░░░▒█████████████████▓▒░  ░▓▓▓▓▓▓▓▓▓▓▓▓▓▓▓▒▒▒░░░░░░░░░░░░   ░░░▒▒▒░░░░░░░░░░░░░ ░░     ░░░▒▒▒▒▒▒░▒▒▒▒▒▒▒▒░█▓▓█▓█████████████████████████████████████████████████████████████████████████████████████
░░░░░░▒▒░░░░▒▒░▒▒▒▓▓███▒░░░▒██████████████████▒▒░  ▒▓▓▓▓▓▓▓▓▓▓▓▓▓▒▒▒░░░░░░░░░░░░░░░░▒▒▒▒▒░░░░ ▒█▒▒█▓▓  ░░░░░░░░░░░▒▒▒▒▒▒▒▒▒▓▓▓██▓░█▓▒███████████████████████████████████████████████████████████████████████████████████████
░░░░░░▒▒░░░░▒▒░▒▒▒▒▓▓█▓▒░░░▒██████████████████▓▒▒░ ░▒▓▓▓▓▓▓▓▓▓▓▓▒▒▒░░░░░░░░░░░░░░▒▒▒▒▒▒▒░░░░  ▒▓▒▓█▓▓  ░░░░░░░░░░▒▒▒▓▓▓▓▓████████░▓▓▒██▓████████████████████████████████████████████████████████████████████████████████████
░░░░░░▒▒░░░░▒▒░▒▒▒▒▓██▓▒░░░▒██████████████████▓▒▒▒░ ░▒▓▓▓▓▓▓▓▓▒▒▒▒░░░░░░░░░░░░░▒▒▒▒▒▒░░░░░░░░ ▒▓▒█▓▓▓  ░░▒▒▒▒▒▒▓▓▓▓██████████████░▓▓▒██▓████████████████████████████████████████████████████████████████████████████████████
░░░░░░▒▒░░░░▒▒░▒▒▒▒▓███▓▒░░▒▓██████████████████▓▒▒▒░░░▒▓▓▓▓▒▒▒▒▒▒░░░░░░░░░░░░░▒▒▒░░░░░░░░░░░▒░▒▓▒██▓▓  ░▒▓▓▓▓▓███████████████████▒▒▓░██▓████████████████████████████████████████████████████████████████████████████████████
░░░░░░▒▒▒░░░▒▒░░▒▒▒▓███▓▒░░░▓███████████████████▓▓▒▒░░░░▒▓▒▒▒▒▒░░░░░░░░░░░░░░░░░▒▒▒▒▒░▒▒▒▒▒▒▒░▒▓▒██▓▓  ░▒▓███████████████████████▒▒▓░██▓████████████████████████████████████████████████████████████████████████████████████
░░░░░░▒▒▒░░░▒▒░░▒▒▒▓▓██▓▒░░░▓█████████████████████▓▒▒▒▒▒░░░▒▒▒▒░░░░░░░░░░░░░░░▒▒▒▒▒▒▒▒▒▒▒▒▒▒▒░▒▓▒██▓▓  ░▒▓███████████████████████▒▒▓░██▓████████████████████████████████████████████████████████████████████████████████████
░░░░░░░▒▒░░░▒▒░░▒▒▒▓▓██▓▒░░░▓██████████████████████▓▓▒▒▒▒▒▒▒▒░░░░░░░░▒▒▒▒▒▒▒▒▒▓▒▓▓▓▓▓▒▓▒▒▒▒▒▒▒▒▓▒██▓▓  ░▒▓▓██████████████████████▒░▓░██▒████████████████████████████████████████████████████████████████████████████████████
░░░░░░░▒▒░░░▒▒▒░░▒▒▓▓██▓▒░░░▓████████████████████████▓▓▒▒▒▒▒▒▒▒▒▒▒▒▒▒▒▒▒▒▒▒▒▓▓█▓▓█▓▓▓▒▒▒▒▒▒▒▒▒▒█▒▓█▓▓   ░▓▓▓█████████████████████░░▓░██▓████████████████████████████████████████████████████████████████████████████████████
░░░░░░░▒▒░░░░▒░░▒▒▒▒▓██▓▒░░░▒██████████████████████████▓▓▓▓▓▒▒▒▒▒▒▒▒▒▒▒▒▒▒▒▓▓▓█▓▓█▓▓▓▒▒▒░▒▒▒▒▒▒▓▒▓███   ░▓▓▓██████████▓▒▒▒▒▒▒▒▒▒░ ░▒░███████████████████████████████████████████████████████████████████████████████████████
░░░░░░░▒▒░░░░▒▒░░▒▒▒▓███▒░░░▒██████████████████████████▓▓▓▓▒▒▒▒▒▒▒▒▒▒▒▒▒▒▒▒▓▓▓█▓▓▓▓▒▓▒▒▒░▒▒▒▒▒▒█▓▓███  ░▒▓▓▓▓▓▓▓▓▓▓▓▓▓▓▓▓▓██████████████████████████████████████████████████████████████████████████████████████████████████
░░░░░░░▒▒░░░░▒░░░▒▒▒▓███▒░░░▒▓█████████████████████████▓▓▓▓▒▒▒▒▒▒▒▒▒▒▒▒▒░▒▒▓▓▓█▓▓▓▒▒▒▒▒▒░▒▒▒▒▒▒█▓▒███▒░▒▒▒▒▓▓▓▓▓████████████████████████████████████████████████████████████████████████████████████████████████████████████
░░░░░░░▒▒░░░░▒▒░░▒▒▒▓███▓░░░▒▓█████████████████████████▓▓▓▓▒▒▒▒▒▒▒▒▒▒▒▒▒░▒▒▓▓▓▓▒▒▓▒▒▒▒▒▒▒░░░░░░▓▒▒███▓▒▒▓▓▓▓█████████████████████████▓▓▓▓▓▓▓████████████████████████████████████████████████████████████████████████████████
░░░░░░░░▒░░░░░▒▒░▒▒▒▓███▓░░░▒▓████████████████████████▓▓▓▓▓▒▒▒▒▒▒▒▒▒▒▒▒▒░▒▒▒▒▓▓▓▓▓▓▒▒▒▒▒░░░  ░░▒▓██████████████████████████▓█▓█▓█▓▓▓██▓█▓▓▓▓████████████████████████████████████████████████████████████████████████████████
░░░░░░░░▒▒░░░░▒▒░░▒▒▓▓██▓▒░░▒▓██████████████████████▓▓▓▓▓▓▓▒▒▒▒▒▒▒▒▒▒▒░▒░▒▒▓▒▓▓▓▓▓▓▒▒▒▒▒░░░░░░░▓████████████████████▓█▓▓▓▓██▓▓█▓██▓▓██▓▓▓▓▓▓████████████████████████████████████████████████████████████████████████████████
░░░░░░░░▒▒░░░░▒▒▒░▒▒▓▓██▓▒░░░▓██████████████████████▓▓▓▓▓▓▒▒▒▒▒▒▒▒▒▒▒▒░░░▒▒▒▒▓▓▓▓▓▓▒▒▒░▒░░░░░░░▒████████▓██▓█▓███▓▓█▓█▓███▓▓█▓▓█▓▓█▓▓▓▓█▓▓▓▓████████████████████████████████████████████████████████████████████████████████
░░░░░░░░▒▒░░░░▒▒░▒▒▒▒▓██▓▒░░░▓█████████████████████▓▓▓▓▓▓▓▒▒▒▒▒▒▒▒▒▒▒▒░▒░▒▒▒▒▓█▓▒▓▒▒▒▒░▒░░░░░░░▒▓▓█████▓█▓██▓▓▓▓██▓▓████▓█▓▓█▓█▓█▓█▓▓▓▓▓▓▓▓▓████████████████████████████████████████████████████████████████████████████████
░░░░░░░░▒▒░░░░▒▒▒░▒▒▒▓██▓▒░░░▓█████████████████████▓▓▓▓▓▓▓▒▒▒▒▒▒▒▒▒▒▒░░░░▒▒▒▒▓▓▒▒▒▒▒▒░░░░ ░ ░░░▒▒██▓██████▓█▓██▓▓██████████▓▓▓█▓▓▓█▓▓▓▓█▓▓▓▓████████████████████████████████████████████████████████████████████████████████
░░░░░░░░▒▒░░░░▒▒▒▒▒▒▒▓▓██▒░░░▓█████████████████████▓▓▒▓▓▒▒▒▒▒▒▒▒▒▒▒▒▒░░░░▒▒▒▒▒▒▒▒▒▒░░░░░░    ░░▒▒██████▓████▓████████████████▓▓██▓▓█▓█▓█▓█▓▓████████████████████████████████████████████████████████████████████████████████
░░░░░░░░▒▒░░░░▒▒▒▒░▒▒▓▓██▒░░░▒███████████████████▓█▓▓▒▓▓▒▒▒▓▒▒▒▒▒▒▒▒▒░░░░░▒▒▒▒▒▒░░░░░░ ░░     ░▒▒████████▓██▓█████████████████▓▓▓▓▓▓█▓█▓▓▓▓▓████████████████████████████████████████████████████████████████████████████████
░░░░░░░░░▒▒░░░░▒▒▒░▒▒▓▓██▒░░░▒███████████████████▓▓▓▓▒▓▓▒▓▒▓▓▒▒▒▒▒▒▒▒░░░░░░░░░░░░░░░░░ ░░     ░▒▒▓███████▓█▓█▓████████████████▓▓▓█▓▓▓█▓█▓█▓▓████████████████████████████████████████████████████████████████████████████████
░░░░░░░░░░▒░░░░▒▒▒░▒▒▒▓██▒░░░▒▓██████████████▓█▓█▓▓▓▓▒▓▓▒▓▒▓▓▒▒▒▒▒▒▒▒░░░░░░░░░░░░░░ ░░░░░     ░░▒▓████▓█▓█████▓████████████████▓▓▓█▓▓█▓▓▓▓▓▓████████████████████████████████████████████████████████████████████████████████
░░░░░░░░░░░░░░░▒▒▒▒▒▒▒▓██▓░░░▒███████████████▓███▓▓▓▓▒▓▓▓▓▓▓▓▒▒▒▒▒▒▒▒░░░░░░░░░░░░░░░░░░░░     ░░▒███▓█████▓▓▓█▓██████████████▓▓▓█▓█▓▓█▓▓▓▓▓▓████████████████████████████████████████████████████████████████████████████████
░░░░░░░░░░░░░░░░▒▒░▒▒▒▓▓█▓▒░░▒▓██████████████▓██▓▓▓▓▓▓▓▓▓▓▓▓▓▒▒▒▒▒▒░░░░░░░░░░░░░░░░░░░░░░     ░░▒█████▓▓███▓█▓▓█▓███████████▓▓▓▓▓▓▓▓▓█▓▓▓▓▓▓████████████████████████████████████████████████████████████████████████████████
░░░░░░░░░░░░░░░░▒▒░▒▒▒▓▓▓▓▒░░▒▓█████████▓███▓█▓▓▓▓▓▓▓▓▓▓▓▓▓▓▓▒▒▒▒▒▒▒▒░░░░░░░░░░░░░░░░░░░░     ░░▒███████▓▓▓▓▓▓█▓▓████████████▓▓▓▓▓▓▓▓▓▓▓▓▓▓▓████████████████████████████████████████████████████████████████████████████████
░░░░░░░░░░░░░░░░░▒░▒▒▒▓▓▓▓▒░░░▓██████████▓██▓▓▓▓▓▓▓█▓▓▓▓▓▓▓▓▓▒▒▒▒▒▒▒▒░░░░░░░░░░░░░░░░░░░░      ░▒▓█▓█▓▓█▓█████▓▓▓▓███████████▓▓▓▓▓▓▓▓▓▓▓▓▓▓▓████████████████████████████████████████████████████████████████████████████████
░░░░░░░░░░░░░░░░░▒░▒▒▒▓▓▓▓▒░░░▓██████████▓███▓▓▓▓▓▓█▓▓▓▓▓▓▓▓▓▒▒▒▒▒▒▒▒▒░░░░░░░░░░░░░░░░░░░     ░░▒▓█████▓█▓▓▓▓▓▓█▓█▓█████████▓▓▓▓▓▓▓▓▓▓▓▓▓▓▓█████████████████████████████████████████████████████████████████████████████████
░░░░░░░░░░▒░░░░░░▒░░▒▒▓▓▓▓▒░░░▓█████████▓▓███▓▓▓▓▓▓█▓▓█▓▓▓▓▓▒▒▒▒▒▒▒▒▒▒░░░░░░▒░░░░░░░░░░▒░░     ░▒▓▓█▓█▓█▓█▓█▓█▓▓▓▓▓▓███████▓▓▓▓▓▓▓▓█████████████████████████████████████████████████████████████████████████████████████████
░░░░░░░░░░▒░ ░░░░░░░▒▒▓▓▓▓▒░░░▒████▓█████▓▓██▓▓▓▓█▓██▓█▓▓▓▓▓▒▒▒▒▒▒▒▒▒▒░░░░░▒▒░▒▒░▒▒░▒▒░▒░░    ░░▒▓▓▓▓▓▓▓▓▓▓▓▓▓▓▓▓▓▓▓▓▓▓▓▓▓██████████████████████████████████████████████████████████████████████████████████████████████████
░░░░░░░░░░░░░░░░░░░░░▒▓▓▓▓▒░ ░▒▓█████████▓▓██▓▓▓▓█▓▓█▓▓▓▓▓▓▓▒▒▒▒▒▒▒▒▒▒░░░░░░▒░▒▒░▒▒░▒░░▒░▒▒░  ░░▒▓▓▓█▓█▓▓▓▓▓▓▓▓▓▓▓██████████████████████████████████████████████████████████████████████████████████████████████████████████
░ ░░░░░░░░░░░░░░░░░░░▒▒▓▓▓▒░░░▒▓█████████▓▓▓█▓▓███▓▓█▓▓▓▓▓▓▓▒▒▒▒▒▒▒▒▒▒░░░░░▒▒░▒▒░▒▒░▒░░▒░▒▒▒░░░░▒▓▓▓▓▓▓▒▒▓▓▓▓█████████████████████████████████████████████████████████████████████████████████████████████████████████████▓▓
░   ░░░░░░░░░░░░░░░░░▒▒▓▓▓▒░ ░▒▓████████▓▓▓██▓▓██▓▓▓▓▓▓▓▓▓▓▒▒▒▒▒▒▒▒▒▒▒░░░░░░▒░▒▒░▒▒░▒▒░▒▒▒▒▒░▒▒░░░░   ░░▒▓▓██████████████████████████████████████████████████████████████████████████████████████████████████████████▓▓▓▓▓▒▒
   ░ ░░░░░░░░ ░░░░░░░▒▒▓▓▓▒░ ░▒▓████████▓▓▓█▓█▓██▓▓▓▓▓▓▓▓▓▓▒▒▒▒▒▒▒▒▒▒▒░░░░░▒░░▒░░▒▒░▒▒░▒░▒▒▒░▒▒░░     ░░▒▓▓██████████████████████████████████████████████████████████████████████████████████████████████████████▓▓▓▓▓▒▒▒▒▒▒
   ░ ░░░░░░░░░░░░░░░░▒▒▓▓▓▓░  ░▓▓███▓████▓▓█▓███▓▓▓▓▓▓▓▓▓▓▒▒▒▒▒▒▒▒▒▒░▒░░▒░░▒▒░▒░░▒▒░▒▒░▒▒▒▒▒░▒▒░░      ░▒▓▓██████████████████████████████████████████████████████████████████████████████████████████████████▓▓▓▓▒▒▒▒▒▒▒▒▒▒░
░  ░  ░░░░░░░░░░░░░░░▒▒▒▓▓▓▒  ░▓▓████████▓███████▓▓▓▓▓▓▓▓▒▒▒▒▒▒▒▒▒▒▒▒▒░░▒░░▒▒░▒░░▒▒░▒▒░▒░▒▒▒░▒▒░░      ░▒▒▓██████████████████████████████████████████████████████████████████████████████████████████████▓▓▓▓▒▒▒▒▒▒▒▒▒░░░░░▒
░  ░ ░ ░░░░░░░░░░░░░░░▒▒▓▓▓▒  ░▓▓██▓▓▓███▓▓█▓█▓█▓▓▓▓▓▓▓▓▓▒▒▒▒▒▒▒▒▒▒░▒▒░░▒░▒▒▒░▒░░▒▒░▒▒░░▒░▒▒░▒▒░░      ░▒▓▓█████████████████████████████████████████████████████████████████████████████████████████▓▓▓▓▒▒▒▒▒▒▒▒▒░░░░░▒▒▒▒▒▒
    ░ ░░░░░░░░░░░░░░░▒▒▒▓▓▓▒░ ░▒▓███▓█████▓█▓█▓█▓▓▓▓▓▓▓▓▓▓▒▒▒▒▒▒▒▒▒▒░▒░░▒░░▒▒░▒▒░▒▒░▒▒░░▒░▒▒░▒▒░░     ░░▒▓▓████████████████████████████████████████████████████████████████████████████████████▓▓▓▓▓▒▒▒▒▒▒▒▒▒░░░▒▒▒▒▒▒▒▒▒▒▒▒
       ░░░░░░░░░░░░░░░▒▒▓▓▓▒░ ░▒▓███▓████▓▓█▓█▓▓▓▓▓▓▓▓▒▓▓▒▒▒▒▒▒▒▒▒▒▒▒▒░░▒░░▒▒░▒▒░▒▒░▒▒░░▒░▒▒░▒▒░░      ░▒▓▓████████████████████████████████████████████████████████████████████████████████▓▓▓▓▓▒▒▒▒▒▒▒▒░░▒▒▒▒▒▒▒▒▒▒▒▓▓▓▓▓▓▓
         ░░░░░ ░░░░░░░▒▒▓▓▓▒░ ░░▓▓██▓████▓▓█▓█▓▓▓▓▓▓▓▓▓▓▓▒▒▒▒▒▒▒▒▒▒▒░▒░░▒░░░▒░▒▒░░▒░░▒░░▒░▒▒░▒▒░░     ░░▒▓▓███████████████████████████████████████████████████████████████████████████▓▓▓▓▒▒▒▒▒▒▒▒▒▒░▒▒▒▒▒▒▒▒▒▒▒▒▓▓▓▓▓▓▓▓▓▓▓
